gɹæs	kɹas
lɔɹl	lɔɹl
dɹæk	dɹag
suɹp	tʊɹb
βoɹf	boɹf
quɹ	kuɹ
bɹuɹ	pɹʊɹ
nɛɹn	nɛɹn
dɹuɹn	tɹuɹn
bɹip	bɹɪp
dɹus	dɹʊs
βɔɹn	bɔɹn
fik	fɪk
sɹɔɹn	sɹɔɹn
lɹes	lɹes
snuɹf	snuɹf
βoɹp	boɹb
ɸon	pon
dɹɛɹs	tɹɛɹs
snost	snost
fel	fel
lufp	lʊfp
dɹoɹl	tɹoɹl
xa	ka
nɹons	nɹons
sut	sud
lɹæt	lɹad
fɹiɹk	fɹɪɹg
nɹiɹf	nɹiɹf
dɹoɹp	tɹoɹb
nuns	nʊns
nɹut	nɹud
siɹp	tɪɹb
kæl	kal
nɹin	nɹɪn
ɸɶs	pas
snɔɹk	snɔɹg
suɹk	tʊɹg
βɔt	bɔd
fɹuf	fɹʊf
xil	kɪl
suɹp	suɹp
lifp	lifp
sil	tɪl
snofp	snofp
lɹuk	lɹug
bɹɔɹl	pɹɔɹl
ɸɔn	pɔn
ip	ɪp
soɹs	soɹs
ɸɔɹk	pɔɹg
ap	ap
snɔns	snɔns
byfp	bɪfp
ɹuɹn	ɹʊɹn
gæt	gad
nɹuɹp	nɹʊɹp
oɹf	oɹf
xiɹl	kiɹl
fuɹn	fuɹn
fɹen	fɹen
son	son
xin	kɪn
sneɹf	sneɹf
zot	dod
bɹoɹt	bɹoɹt
bɹut	bɹʊt
bɹɛɹk	bɹɛɹk
lɹip	lɹɪp
ut	ʊd
pɸins	pfins
snɛf	snɛf
ɹuk	ɹʊk
pɸiɹp	pfiɹp
niɹs	nɪɹs
fok	fog
snɛp	snɛp
fɹɔɹ	fɹɔɹ
sɛt	sɛt
bɹest	pɹest
fuf	fʊf
dɹuɹk	tɹʊɹg
xil	kil
ɹɛɹt	ɹɛɹd
nɹɔɹn	nɹɔɹn
pɸɔɹs	pfɔɹs
ɛf	ɛf
tsiɹp	tsɪɹb
gɹuɹp	kɹʊɹp
gɹup	gɹʊp
βøɹt	beɹd
ins	ins
xiɹk	kɪɹk
sɔt	sɔd
bɹɔf	pɹɔf
nɹet	nɹed
ɸœn	pɛn
bɹeɹf	bɹeɹf
ɣɛɹk	gɛɹk
ɸus	pus
gɹoɹp	kɹoɹp
βɶp	bab
dɹɔl	dɹɔl
lɹɔɹ	lɹɔɹ
siɹ	siɹ
dɹuɹs	tɹuɹs
pɸiɹt	pfɪɹd
pyp	pɪp
zoɹn	doɹn
snɛɹt	snɛɹd
næp	nap
fɹoɹp	fɹoɹp
siɹp	sɪɹb
kæt	kad
ɣiɹp	gɪɹp
tsi	tsɪ
nɹup	nɹʊp
bɹul	pɹʊl
fɹins	fɹɪns
nɹiɹl	nɹɪɹl
fit	fɪt
dæɹp	daɹb
sniɹs	sniɹs
ɸɶn	pan
bɹi	pɹi
sneɹt	sneɹd
βɔf	bɔf
afp	afp
ɸœk	pɛg
seɹt	seɹt
nɹiɹf	nɹɪɹf
bɹins	pɹɪns
pɸiɹk	pfiɹg
ɹep	ɹep
zuk	dʊk
ɹist	ɹɪst
tsɛt	tsɛd
sɹɛɹt	sɹɛɹd
zis	dis
sens	tens
dɹeɹt	dɹeɹd
pɸuns	pfʊns
fɹek	fɹeg
zip	dip
ɸœst	pɛst
fɹuɹs	fɹʊɹs
bɹif	bɹif
sil	sil
qu	kʊ
siɹp	tiɹp
snes	snes
snit	snɪt
dɹæp	tɹap
sip	tɪp
xep	keb
βœf	bɛf
fɹæt	fɹat
gɹæk	gɹag
nɹæn	nɹan
dɹifp	tɹifp
dɹuɹp	tɹʊɹp
βiɹk	biɹk
fɹɛɹk	fɹɛɹg
fet	fed
lɹɛɹp	lɹɛɹp
nuɹf	nuɹf
fɹɛɹl	fɹɛɹl
gɹit	gɹɪt
bɹis	pɹɪs
nɹɛp	nɹɛp
fuɹp	fuɹp
noɹs	noɹs
βop	bop
zist	dist
sna	sna
tsun	tsʊn
βøɹp	beɹp
ɣik	gɪg
nɹɔs	nɹɔs
dɹun	dɹʊn
lɹuɹf	lɹuɹf
gɹɛɹ	gɹɛɹ
gɹup	gɹʊb
snup	snʊb
bɹefp	bɹefp
fɔɹk	fɔɹk
sins	sins
dɹɛt	tɹɛd
sɹul	sɹʊl
nuɹt	nuɹt
læɹk	laɹg
fit	fɪd
læns	lans
sɔns	sɔns
pɸiɹs	pfiɹs
sɹu	sɹʊ
dɹoɹ	dɹoɹ
ul	ul
pɸuɹp	pfuɹb
βif	bif
ɣɛk	gɛk
bɹiɹk	pɹɪɹg
sniɹ	sniɹ
nɹæk	nɹak
ol	ol
et	et
luk	luk
ɣeɹp	geɹp
nuɹt	nʊɹd
dɹeɹk	tɹeɹg
bɹiɹk	bɹiɹg
dɹɔk	tɹɔk
bɹiɹp	bɹiɹb
tsuɹp	tsuɹb
næk	nak
ɹɔɹs	ɹɔɹs
fɛɹs	fɛɹs
βuɹp	bʊɹp
ɸip	pip
tsons	tsons
dɹæl	tɹal
nɔst	nɔst
nɹoɹt	nɹoɹt
ɢufp	gʊfp
pɸip	pfip
tæp	tap
gɹɛn	gɹɛn
fɹons	fɹons
suɹp	tuɹp
ɣɛɹ	gɛɹ
it	ɪd
gɹoɹs	kɹoɹs
bɹæɹt	bɹaɹd
nɹit	nɹɪt
ɹɛp	ɹɛp
xeɹp	keɹp
xiɹs	kiɹs
dɹifp	dɹifp
snuns	snʊns
dɹɔfp	dɹɔfp
gɹæp	kɹab
dɹæɹp	dɹaɹb
ɸøt	pet
nuɹf	nʊɹf
fep	fep
lɹup	lɹʊp
βɶt	bad
bɹiɹn	pɹɪɹn
uns	ʊns
dɹup	dɹʊb
lef	lef
ɣes	ges
gɹɔ	kɹɔ
zɛɹp	dɛɹp
ip	ɪb
qok	kok
nɔ	nɔ
ɹufp	ɹufp
bɹoɹp	pɹoɹb
gɹis	gɹis
tsiɹ	tsiɹ
soɹk	toɹk
sof	sof
fɹot	fɹod
lɹoɹl	lɹoɹl
ziɹp	dɪɹp
kæɹf	kaɹf
fiɹp	fiɹb
zeɹl	deɹl
ɹɛɹf	ɹɛɹf
sɹuɹ	sɹuɹ
nɹiɹ	nɹiɹ
eɹl	eɹl
fɹɔɹk	fɹɔɹk
pɸoɹk	pfoɹg
sul	tʊl
lɛɹt	lɛɹt
sæns	sans
uɹs	uɹs
gɹip	gɹɪb
ɹiɹ	ɹiɹ
zeɹ	deɹ
dæp	dab
bɹæɹ	pɹaɹ
lɹuns	lɹʊns
liɹt	liɹd
snɔst	snɔst
nɔɹp	nɔɹp
lɹɛɹ	lɹɛɹ
dæf	daf
uɹt	ʊɹd
lɛfp	lɛfp
noɹ	noɹ
lif	lif
nɹɔɹk	nɹɔɹg
fɛɹn	fɛɹn
fɹæɹp	fɹaɹp
qup	kʊp
fɔɹp	fɔɹb
xiɹf	kiɹf
fɹip	fɹɪp
byɹf	bɪɹf
nɹuf	nɹʊf
ɹi	ɹi
sɹip	sɹib
pɸiɹp	pfɪɹp
næɹt	naɹt
suɹk	suɹg
dɹeɹs	dɹeɹs
tsɛɹn	tsɛɹn
gɹɛk	kɹɛg
bɹoɹ	bɹoɹ
tsæɹ	tsaɹ
nɹuɹ	nɹʊɹ
gɹiɹn	gɹɪɹn
ɣens	gens
niɹt	niɹd
nip	nip
lɛɹk	lɛɹg
fɹut	fɹʊt
eɹs	eɹs
dɹiɹt	dɹɪɹd
dɹiɹf	tɹɪɹf
nof	nof
qɔs	kɔs
ɹɔk	ɹɔk
lɹiɹk	lɹiɹg
kæk	kak
ɸøp	peb
fɹuɹ	fɹuɹ
sifp	tɪfp
sɹɛns	sɹɛns
ɣeɹt	geɹt
dɹɛf	dɹɛf
tsik	tsɪk
ɸiɹp	piɹb
βup	bub
sneɹp	sneɹp
lok	lok
snɛɹp	snɛɹb
ɣɛɹs	gɛɹs
bɹoɹf	bɹoɹf
xip	kɪp
leɹ	leɹ
lɹol	lɹol
tsust	tsust
soɹs	toɹs
bɹɛf	pɹɛf
gɹuɹ	gɹuɹ
fɹæn	fɹan
fɔs	fɔs
tsiɹt	tsɪɹd
dɹon	dɹon
zoɹs	doɹs
sɹæst	sɹast
ɣiɹt	gɪɹt
funs	funs
lɹeɹp	lɹeɹp
snuf	snʊf
gɹip	kɹɪp
xɛn	kɛn
dɹɛ	dɹɛ
snæl	snal
fɹip	fɹɪb
dɹot	dɹod
pɸif	pfif
siɹk	tɪɹk
dɹut	dɹut
nɹeɹk	nɹeɹg
nɹu	nɹu
βon	bon
ɢop	gob
lɔfp	lɔfp
ɣefp	gefp
ɣep	geb
sɹiɹt	sɹɪɹt
xɛs	kɛs
nɹæf	nɹaf
gɹæn	kɹan
sɹɛl	sɹɛl
lɔk	lɔk
fɹiɹf	fɹiɹf
byn	bɪn
lɹɔɹn	lɹɔɹn
βɔst	bɔst
dɹiɹp	dɹɪɹp
gɹiɹk	gɹiɹg
fiɹt	fiɹd
βoɹt	boɹd
bɹæɹk	pɹaɹg
dɹufp	dɹʊfp
pɸoɹf	pfoɹf
bɹos	bɹos
bɹuns	pɹʊns
ɹɛ	ɹɛ
lins	lins
lɛn	lɛn
ɹɔ	ɹɔ
sok	tog
pyɹn	pɪɹn
let	let
lɹust	lɹust
soɹf	toɹf
bɹɛɹp	bɹɛɹb
sop	top
nuk	nʊg
fuɹt	fuɹt
tæs	tas
snæt	snat
gɹe	kɹe
xiɹp	kiɹb
gɹæɹn	kɹaɹn
xik	kɪg
ɣif	gif
lɛt	lɛd
xist	kɪst
lɹoɹn	lɹoɹn
ɸœɹk	pɛɹk
lɛɹl	lɛɹl
dɹæns	tɹans
gɹoɹs	gɹoɹs
sɹɔt	sɹɔd
gɹiɹt	gɹɪɹt
βuɹt	buɹt
ost	ost
dɹɔɹ	tɹɔɹ
ɸɶfp	pafp
bɹit	pɹit
li	lɪ
ɣɛɹk	gɛɹg
pɸæs	pfas
dɹet	tɹed
iɹf	iɹf
pɸoɹk	pfoɹk
gɹiɹt	gɹiɹd
soɹn	soɹn
βɔɹt	bɔɹt
bɹik	bɹig
sɹɔɹp	sɹɔɹb
ɢoɹn	goɹn
bɹuɹt	pɹʊɹt
gɹɔɹ	kɹɔɹ
tsɛɹk	tsɛɹg
dɹoɹf	dɹoɹf
pɸon	pfon
nɹɔɹ	nɹɔɹ
βœɹs	bɛɹs
dɹo	dɹo
snut	snʊt
lɹeɹk	lɹeɹk
ɹut	ɹʊt
sit	sɪt
βuɹk	buɹg
sɹuf	sɹʊf
pɸæp	pfap
ɸoɹn	poɹn
ɸøɹp	peɹp
set	tet
bɹɛl	bɹɛl
fɹɛɹt	fɹɛɹd
ɢup	gʊb
dɹæl	dɹal
tæɹ	taɹ
lɹɔk	lɹɔg
pɸost	pfost
nɹin	nɹin
zoɹt	doɹt
ɸɔɹl	pɔɹl
ɹens	ɹens
dɹun	tɹun
βøk	beg
nek	nek
βɶɹ	baɹ
nɹɔt	nɹɔd
pɸeɹ	pfeɹ
nɹɛɹt	nɹɛɹd
snuɹp	snuɹp
ɛns	ɛns
py	pɪ
sɹif	sɹif
lɹuɹl	lɹuɹl
gɹæl	gɹal
gɹæɹf	kɹaɹf
ɸik	pik
ziɹl	diɹl
xɛɹp	kɛɹb
fɹæɹs	fɹaɹs
ɹuɹp	ɹuɹb
ɹuɹl	ɹʊɹl
gɹiɹp	gɹɪɹp
pɸi	pfi
sun	tʊn
dɹɔp	dɹɔp
sɔɹp	sɔɹb
fɹɔfp	fɹɔfp
dɹoɹk	tɹoɹg
dɹop	dɹop
lɹip	lɹip
bɹoɹs	bɹoɹs
gɹiɹl	gɹiɹl
nɔɹn	nɔɹn
bɹæɹf	pɹaɹf
xɛɹf	kɛɹf
pɸɛst	pfɛst
sɔɹk	sɔɹg
dɹof	dɹof
dɹiɹp	tɹiɹp
sɔɹp	tɔɹp
zɛ	dɛ
lɹiɹs	lɹɪɹs
iɹp	iɹb
snæk	snag
sɛ	tɛ
uɹn	ʊɹn
ɸøk	peg
ɢuns	guns
ɹɔɹk	ɹɔɹg
quɹt	kʊɹt
nɹoɹl	nɹoɹl
kæɹk	kaɹk
nɹet	nɹet
ɹɛk	ɹɛg
fok	fok
bɹiɹt	pɹiɹd
liɹt	liɹt
liɹp	lɪɹp
βɔp	bɔb
ɢɔs	gɔs
nɹɔns	nɹɔns
fɹuɹk	fɹʊɹg
ɹiɹt	ɹɪɹd
gɹufp	gɹufp
nɹɔk	nɹɔg
pɸep	pfep
gɹost	kɹost
kæɹp	kaɹb
gɹɛp	kɹɛb
gɹɔk	kɹɔk
dɹip	tɹib
dɹɔɹp	tɹɔɹb
dɹæn	dɹan
fɔns	fɔns
bɹɔɹ	pɹɔɹ
pɸɔɹt	pfɔɹd
xɛɹn	kɛɹn
fu	fʊ
zifp	dɪfp
fɹɛɹk	fɹɛɹk
fɹup	fɹub
bɹuɹt	bɹʊɹd
sɹist	sɹist
dɹi	dɹɪ
sit	tɪt
ɹuɹp	ɹʊɹb
βiɹt	biɹt
gɹust	kɹust
lɹeɹk	lɹeɹg
ɹuk	ɹuk
gɹist	gɹɪst
kæp	kab
fik	fɪg
zin	din
pɸet	pfed
ziɹk	diɹg
ɢɔɹk	gɔɹg
gɹik	kɹik
dɹɛɹk	dɹɛɹg
nɔk	nɔg
tsɛs	tsɛs
lɹæɹt	lɹaɹt
lɹuɹt	lɹuɹd
nɹe	nɹe
ɸøs	pes
lin	lin
fɹɛk	fɹɛk
dɹɔst	dɹɔst
sɹeɹs	sɹeɹs
kæn	kan
tsuɹt	tsʊɹt
ɣet	get
qul	kʊl
i	i
gæɹt	gaɹd
sɹuɹt	sɹuɹd
ɹɛt	ɹɛt
dɹuns	dɹuns
ɣiɹl	giɹl
bɹæfp	bɹafp
gæl	gal
qoɹk	koɹg
snɔn	snɔn
fɹis	fɹɪs
snɔ	snɔ
lɹɛɹs	lɹɛɹs
snæs	snas
zi	di
lɹiɹp	lɹɪɹp
dɹup	dɹub
lɹæɹs	lɹaɹs
snɔs	snɔs
snɛt	snɛd
bɹɔp	pɹɔb
sɔl	tɔl
bɹæt	pɹat
sɛk	tɛg
lip	lɪb
bɹu	pɹu
fɹɛt	fɹɛt
nɹuɹk	nɹʊɹk
pɸɔɹk	pfɔɹg
βut	bʊd
gɹufp	kɹufp
siɹk	sɪɹk
gɹuɹs	kɹuɹs
ɢoɹk	goɹk
pɸok	pfok
læɹt	laɹt
zeɹk	deɹk
βɔns	bɔns
bɹuɹk	pɹuɹg
gɹɔɹs	gɹɔɹs
fis	fis
zul	dʊl
dɹæt	tɹad
ɢun	gʊn
suɹp	suɹb
sɹɛɹk	sɹɛɹk
pɸup	pfub
fɹoɹn	fɹoɹn
sɹef	sɹef
gɹes	gɹes
aɹn	aɹn
βøɹl	beɹl
gɹif	gɹif
quf	kuf
dɹuɹp	dɹuɹb
lɹɔɹk	lɹɔɹk
snæɹn	snaɹn
fɹuɹt	fɹuɹt
snɔp	snɔb
suns	tʊns
luɹt	luɹd
sɹæf	sɹaf
lɹæf	lɹaf
gɹiɹf	kɹiɹf
seɹt	teɹt
lɹifp	lɹɪfp
pɸɛfp	pfɛfp
gɹoɹl	gɹoɹl
nɛɹt	nɛɹd
dɹɛɹk	dɹɛɹk
dɹeɹt	tɹeɹt
lɹen	lɹen
niɹk	niɹg
gɹɔk	gɹɔk
lɹɔl	lɹɔl
ifp	ɪfp
ɸɶɹk	paɹk
snɔɹs	snɔɹs
qot	kot
snuns	snuns
gɹiɹs	gɹɪɹs
ɣeɹl	geɹl
bɹeɹk	bɹeɹg
gɹɔf	kɹɔf
qost	kost
zu	dʊ
lɔns	lɔns
fæt	fad
snuɹt	snʊɹt
ik	ik
qɔɹt	kɔɹt
fiɹs	fiɹs
ɹuɹk	ɹʊɹg
pɸi	pfɪ
ɹɛɹk	ɹɛɹk
snist	snɪst
pyk	pɪg
ɣɛfp	gɛfp
ɸuns	pʊns
pɸɛ	pfɛ
dɹiɹn	tɹiɹn
bɹot	bɹod
at	ad
byk	bɪg
ɔst	ɔst
seɹk	teɹg
pɸæl	pfal
nɹifp	nɹɪfp
fɹost	fɹost
siɹt	tiɹt
bɹuɹt	pɹuɹt
ɛɹt	ɛɹd
neɹs	neɹs
dɹuɹp	tɹuɹp
xɛp	kɛb
sɹins	sɹins
snins	snɪns
fɹiɹk	fɹɪɹk
luns	lʊns
βɶɹt	baɹd
βɶɹf	baɹf
βus	bʊs
sæɹ	saɹ
sɔɹk	tɔɹk
xiɹp	kɪɹb
βiɹk	biɹg
gɹɛɹp	kɹɛɹp
ɹiɹk	ɹiɹk
βøp	beb
eɹp	eɹp
βɶl	bal
lɹust	lɹʊst
dɹot	tɹod
βøn	ben
fɹɛɹp	fɹɛɹb
gɹiɹp	gɹiɹp
ɹis	ɹɪs
sæt	sad
sɹons	sɹons
siɹf	tiɹf
tsɔf	tsɔf
næns	nans
ɣiɹt	gɪɹd
pɸuɹn	pfʊɹn
tæk	tag
qɔɹk	kɔɹg
tsuɹf	tsʊɹf
ɹiɹk	ɹiɹg
zɔ	dɔ
qɔɹn	kɔɹn
suɹk	sʊɹg
sɹoɹt	sɹoɹt
dɹins	tɹɪns
lut	lut
sɔ	tɔ
bɹɔt	pɹɔt
lus	lus
dɹæst	tɹast
nɹis	nɹɪs
fiɹ	fiɹ
lofp	lofp
kæk	kag
nɹiɹn	nɹiɹn
niɹp	nɪɹb
lɹet	lɹet
ɹa	ɹa
fɹet	fɹet
soɹp	toɹp
siɹk	siɹg
soɹt	toɹd
lɹɔ	lɹɔ
ak	ag
nɹep	nɹeb
quɹp	kʊɹp
fɹiɹs	fɹɪɹs
βuɹl	buɹl
lɛɹp	lɛɹb
fiɹs	fɪɹs
pɸɛn	pfɛn
βi	bi
ɹot	ɹod
βɔk	bɔk
lun	lʊn
pɸɔɹt	pfɔɹt
ɢuɹ	guɹ
bɹuf	pɹuf
βuk	buk
fɹil	fɹɪl
snɛk	snɛg
ɔɹ	ɔɹ
dɹons	dɹons
zun	dun
fɹæɹl	fɹaɹl
βuɹn	buɹn
soɹp	soɹp
bɹɔn	pɹɔn
dɹel	tɹel
pɸɔp	pfɔp
lɛɹf	lɛɹf
qɔɹt	kɔɹd
dɹæɹl	dɹaɹl
bɹiɹt	bɹiɹd
bɹuk	pɹug
gɹik	kɹɪg
dɹuɹk	tɹuɹk
lɹiɹf	lɹɪɹf
sɹɔɹk	sɹɔɹk
bɹuɹ	bɹuɹ
ɣis	gɪs
liɹf	lɪɹf
dɹu	dɹu
bɹuɹt	bɹuɹd
dɹæt	tɹat
suɹ	tuɹ
sɔɹn	tɔɹn
bɹup	bɹʊp
bɹuɹf	bɹʊɹf
bɹeɹk	bɹeɹk
ap	ab
ɹeɹt	ɹeɹd
gɹoɹt	kɹoɹd
iɹp	ɪɹp
zɔɹt	dɔɹd
bɹus	bɹus
zɔk	dɔg
fɹɔt	fɹɔd
fut	fʊd
sneɹn	sneɹn
bɹul	bɹul
fuk	fuk
nɔns	nɔns
lufp	lufp
qɔɹp	kɔɹb
sin	tin
nɹeɹp	nɹeɹb
nɔk	nɔk
fɹut	fɹud
ziɹs	diɹs
ɢuf	guf
lɹis	lɹis
bɹeɹp	bɹeɹp
sneɹk	sneɹg
fuɹl	fʊɹl
bɹip	pɹip
sɹiɹf	sɹiɹf
nɹek	nɹeg
zɛl	dɛl
nes	nes
zif	dɪf
tsuns	tsuns
tsiɹs	tsɪɹs
nɹɔɹt	nɹɔɹt
lɹuɹp	lɹuɹb
gɹæt	gɹad
bɹiɹn	bɹɪɹn
tsɛl	tsɛl
ɣɛɹt	gɛɹd
ɣiɹn	gɪɹn
sɔk	sɔg
bɹɛfp	pɹɛfp
snæp	snap
fɹæɹk	fɹaɹk
βɶɹl	baɹl
bɹɔɹk	pɹɔɹg
gɹuɹt	gɹʊɹt
dɹik	tɹɪg
gɹɔ	gɹɔ
sufp	sufp
ɸuɹf	puɹf
dɹuk	tɹug
tsoɹ	tsoɹ
dɹu	tɹʊ
ɸœɹl	pɛɹl
siɹs	siɹs
lɹut	lɹʊt
sɹus	sɹʊs
up	ub
snik	snɪg
nɹæl	nɹal
zin	dɪn
loɹp	loɹp
fɹit	fɹɪt
suɹf	sʊɹf
læp	lab
niɹk	niɹk
tæn	tan
dɹiɹt	dɹɪɹt
dɹɛst	dɹɛst
βɶf	baf
dɹiɹp	dɹɪɹb
uɹl	ʊɹl
bɹæt	pɹad
fɹut	fɹut
ɛk	ɛk
tsi	tsi
zɔt	dɔt
snus	snus
nɹæɹ	nɹaɹ
bɹuɹ	pɹuɹ
liɹt	lɪɹd
gɹun	gɹʊn
bɹæɹt	bɹaɹt
ziɹk	diɹk
lɹens	lɹens
gɹuɹl	kɹʊɹl
dɹuɹs	dɹuɹs
gɹɔɹs	kɹɔɹs
snɔɹp	snɔɹb
sɛst	tɛst
neɹl	neɹl
kæɹ	kaɹ
neɹp	neɹp
tsuɹl	tsuɹl
gɹoɹl	kɹoɹl
nɹiɹp	nɹɪɹp
tsuk	tsuk
nɹefp	nɹefp
gɹeɹf	gɹeɹf
næɹn	naɹn
lɹuɹk	lɹuɹk
bɹɛɹk	pɹɛɹg
fɔɹp	fɔɹp
zɛɹs	dɛɹs
gæt	gat
iɹk	ɪɹk
ɸɶl	pal
dɹuɹn	dɹuɹn
dɹeɹk	tɹeɹk
nɛns	nɛns
dɹes	dɹes
tsek	tsek
ɸul	pul
lɹiɹ	lɹɪɹ
lɛɹs	lɛɹs
βuɹf	buɹf
gɹɛɹs	gɹɛɹs
sɹil	sɹil
qus	kus
gɹɔɹt	gɹɔɹt
bɹɔt	bɹɔd
sist	sist
nup	nub
βøst	best
pɸɛɹl	pfɛɹl
tsos	tsos
dɹiɹf	dɹiɹf
sɹɔn	sɹɔn
niɹf	niɹf
ɹiɹs	ɹɪɹs
bɹik	bɹɪk
gɹoɹn	kɹoɹn
nɹoɹ	nɹoɹ
fɹet	fɹed
bɹoɹk	pɹoɹk
bɹuɹp	bɹuɹp
gɹifp	kɹɪfp
qɔk	kɔg
sɔɹp	sɔɹp
xiɹk	kɪɹg
bɹɛp	bɹɛb
sɹok	sɹok
sup	tub
zɛp	dɛb
gɹus	gɹus
gɹuɹn	kɹuɹn
bɹæɹf	bɹaɹf
pɸoɹn	pfoɹn
lo	lo
næt	nad
gɹoɹn	gɹoɹn
sot	tot
pɸæt	pfat
ɹuns	ɹʊns
zof	dof
fɹuns	fɹʊns
fɔɹk	fɔɹg
βɶ	ba
pɸɔ	pfɔ
ɸun	pʊn
suf	suf
pɸæɹt	pfaɹt
gɹuɹp	gɹuɹb
ɢon	gon
fɹɛ	fɹɛ
niɹn	nɪɹn
zup	dʊp
βuɹ	bʊɹ
βœfp	bɛfp
gɹis	gɹɪs
sut	sut
nɹens	nɹens
siɹn	tiɹn
fuk	fug
zep	dep
ɢuk	gug
sɹiɹp	sɹiɹp
gɹep	kɹep
fɹiɹp	fɹiɹb
bɹufp	pɹʊfp
fɹiɹl	fɹiɹl
dæɹl	daɹl
lɹoɹk	lɹoɹk
fɹok	fɹog
lɹin	lɹin
pɸofp	pfofp
nɛp	nɛp
dɹuɹl	dɹʊɹl
ɣɛs	gɛs
ɹun	ɹun
nut	nut
feɹf	feɹf
tsef	tsef
bɹɛk	bɹɛg
gɹist	kɹist
suk	suk
nɹæɹs	nɹaɹs
sɹɛp	sɹɛp
bɹuɹk	bɹʊɹg
ɹe	ɹe
ɢuɹt	guɹt
snæɹs	snaɹs
fɹɛɹf	fɹɛɹf
ɹit	ɹid
nit	nid
sæɹt	saɹd
nɹæp	nɹap
fɛɹk	fɛɹg
dɹup	dɹup
byɹk	bɪɹk
bɹæk	pɹak
bɹiɹp	bɹiɹp
lɹuɹs	lɹʊɹs
dɹot	dɹot
bɹɔɹp	bɹɔɹb
sɛɹp	tɛɹb
gɹit	kɹid
βis	bis
ist	ɪst
fɹut	fɹʊd
gɹiɹs	kɹiɹs
zu	du
snɔp	snɔp
ɣɛn	gɛn
fo	fo
sit	sit
sɔɹ	tɔɹ
βøs	bes
lus	lʊs
sɔfp	tɔfp
fɹeɹs	fɹeɹs
pɸɔɹp	pfɔɹp
luɹp	lʊɹb
sɛɹk	sɛɹg
al	al
pɸæst	pfast
βuɹt	buɹd
byp	bɪp
pɸiɹ	pfɪɹ
pɸeɹt	pfeɹd
bɹɛɹs	bɹɛɹs
gɹuns	kɹʊns
næst	nast
dɹɛɹt	tɹɛɹd
læt	lat
lɹiɹp	lɹɪɹb
qoɹt	koɹt
na	na
pɸæɹ	pfaɹ
lɹɔst	lɹɔst
ɹup	ɹup
ɣɛp	gɛb
nɹa	nɹa
nɹus	nɹʊs
ɸup	pub
et	ed
ut	ʊt
fist	fist
gɹæɹn	gɹaɹn
nɹuɹ	nɹuɹ
βuɹk	bʊɹk
nɹæfp	nɹafp
xɛp	kɛp
niɹf	nɪɹf
sik	sɪg
zuɹf	duɹf
ɛfp	ɛfp
ɹoɹk	ɹoɹg
fɛl	fɛl
dɹen	tɹen
ɸot	pod
sɹest	sɹest
fif	fɪf
ɹɛɹp	ɹɛɹb
ens	ens
ɸøɹl	peɹl
lɹɔɹt	lɹɔɹt
ɣiɹk	gɪɹk
dɹuɹk	tɹuɹg
gɹæɹk	kɹaɹk
lok	log
sniɹs	snɪɹs
gɹoɹp	gɹoɹb
βun	bʊn
snæɹt	snaɹt
sens	sens
gɹot	gɹod
suɹk	tuɹg
nɹufp	nɹufp
bɹoɹp	bɹoɹb
xis	kis
dɹip	tɹɪb
nɹiɹk	nɹiɹg
βøt	bet
gɹɛk	gɹɛg
foɹt	foɹd
lik	lig
lɹæɹt	lɹaɹd
nut	nud
dɹiɹk	tɹiɹg
ɹuɹl	ɹuɹl
siɹt	siɹd
gɹuɹn	gɹʊɹn
nik	nik
ɹɔɹp	ɹɔɹp
ɸɔɹp	pɔɹb
dɹæɹl	tɹaɹl
nɹɛɹk	nɹɛɹg
dɹiɹk	tɹɪɹk
gɹoɹp	gɹoɹp
eɹt	eɹt
nif	nɪf
gɹofp	kɹofp
tsuɹl	tsʊɹl
xet	ket
snɔl	snɔl
gɹul	gɹʊl
ɢu	gʊ
zot	dot
ɹis	ɹis
tses	tses
ɢust	gust
los	los
ɹɛɹn	ɹɛɹn
lɹɔɹk	lɹɔɹg
ɸust	pʊst
gɹɔfp	kɹɔfp
pɸuf	pfʊf
sip	tip
sip	sɪb
bɹɛk	pɹɛk
fɹus	fɹʊs
pɸuk	pfug
ɔɹs	ɔɹs
ɣɛɹf	gɛɹf
gɹæst	gɹast
ɸiɹp	piɹp
lɛs	lɛs
gɹuf	gɹuf
gɹuɹs	gɹuɹs
ɣɛl	gɛl
ɸuɹl	pʊɹl
βœɹ	bɛɹ
siɹp	siɹp
gɹæt	kɹad
gɹep	gɹep
foɹ	foɹ
lɹeɹt	lɹeɹt
lɹuns	lɹuns
gɹæf	kɹaf
gɹit	gɹit
bɹɛp	bɹɛp
fæp	fap
bɹɔɹt	bɹɔɹd
nɹins	nɹɪns
nuɹp	nuɹp
sniɹn	snɪɹn
bɹiɹk	bɹɪɹg
dɹiɹk	tɹɪɹg
fɹuk	fɹuk
suns	suns
feɹl	feɹl
zuɹp	dʊɹb
ɢuɹl	gʊɹl
βɶɹk	baɹg
qɔɹ	kɔɹ
nɹofp	nɹofp
ɹɔt	ɹɔd
zoɹk	doɹg
ɹæɹt	ɹaɹt
dɹuɹp	dɹuɹp
gæk	gag
gɹɔns	gɹɔns
gɹin	kɹin
xen	ken
nen	nen
ɸu	pʊ
ɹɔɹf	ɹɔɹf
pɸɔk	pfɔg
ɣiɹf	gɪɹf
snæp	snab
nɹæɹf	nɹaɹf
bɹa	bɹa
iɹl	iɹl
nɹæɹt	nɹaɹt
nɔl	nɔl
zut	dʊd
bɹæɹp	pɹaɹb
dɹɔɹn	tɹɔɹn
dɹɛt	dɹɛd
dɹoɹs	tɹoɹs
lɹæl	lɹal
luɹk	luɹk
dɹæɹs	tɹaɹs
sæɹs	saɹs
ɢuɹn	gʊɹn
gɹiɹf	gɹiɹf
ɹif	ɹif
dɹup	tɹub
snæɹk	snaɹg
dɹuf	tɹʊf
siɹk	tiɹg
pɸut	pfud
tsit	tsid
dæp	dap
lɹɛt	lɹɛd
fɹɔɹt	fɹɔɹd
ɹeɹl	ɹeɹl
sus	sʊs
ɸoɹ	poɹ
ɣeɹn	geɹn
un	un
bɹuɹl	pɹʊɹl
pɸɛns	pfɛns
ɣist	gist
bɹuf	bɹuf
pɸip	pfib
bɹæp	bɹap
gæɹp	gaɹp
lɛp	lɛb
tæɹk	taɹg
bɹɔɹk	bɹɔɹg
ziɹt	diɹd
qoɹp	koɹb
zut	dut
seɹ	seɹ
bɹiɹl	bɹɪɹl
xeɹf	keɹf
sɹiɹs	sɹiɹs
sefp	tefp
tsiɹp	tsiɹp
fɛf	fɛf
dɹæk	tɹak
fɔɹl	fɔɹl
dæt	dat
ɣiɹs	giɹs
ɢup	gʊp
dɹɔs	tɹɔs
byk	bɪk
byt	bɪt
βɶɹk	baɹk
uɹp	uɹb
lɹæp	lɹab
sot	tod
dɹest	dɹest
sɛns	sɛns
sep	sep
sæɹf	saɹf
ɸuf	puf
tsɔk	tsɔk
lɹɛɹf	lɹɛɹf
ɹun	ɹʊn
bɹet	bɹed
ɹik	ɹik
fɹep	fɹeb
sɔn	sɔn
dɹust	tɹʊst
ɣeɹs	geɹs
lu	lu
soɹk	toɹg
dɹit	dɹit
lɹefp	lɹefp
set	set
fɹus	fɹus
sɹuɹs	sɹʊɹs
lɹel	lɹel
liɹn	liɹn
fil	fil
bɹɔp	bɹɔb
bɹeɹ	bɹeɹ
sup	tʊb
ɹæst	ɹast
fɹæst	fɹast
ɣeɹk	geɹk
fɹin	fɹin
snuɹt	snʊɹd
bɹost	pɹost
sɹun	sɹun
nuɹl	nuɹl
tsin	tsɪn
zik	dig
ɹɔɹn	ɹɔɹn
sni	snɪ
nɹest	nɹest
suɹl	sʊɹl
ɹoɹp	ɹoɹp
bɹik	pɹɪk
gɹi	kɹɪ
gɹæp	gɹap
dɹɛɹt	dɹɛɹt
bɹeɹk	pɹeɹk
dɹɛt	tɹɛt
gɹɛɹk	kɹɛɹk
dɹɛp	tɹɛb
ɔɹf	ɔɹf
fɛɹp	fɛɹp
ɹiɹn	ɹɪɹn
dɹeɹk	dɹeɹk
nɹɛf	nɹɛf
fuk	fʊk
byɹ	bɪɹ
dɹɔt	dɹɔt
sɔɹt	tɔɹd
dɹus	tɹʊs
dæɹt	daɹd
seɹn	seɹn
qos	kos
gɹæɹk	gɹaɹg
lɹɛs	lɹɛs
sɹuɹk	sɹuɹg
sɹik	sɹik
fiɹp	fɪɹb
siɹp	siɹb
sɹoɹ	sɹoɹ
sɹuɹl	sɹuɹl
xɛɹt	kɛɹt
sik	tɪk
uɹt	uɹt
byt	bɪd
bɹiɹk	bɹiɹk
aɹt	aɹd
læk	lag
gɹufp	gɹʊfp
fɹeɹl	fɹeɹl
pɸuɹp	pfʊɹb
lɹuɹn	lɹuɹn
fɹoɹt	fɹoɹt
βɔp	bɔp
sɹif	sɹɪf
gɹofp	gɹofp
sneɹ	sneɹ
sek	seg
tsa	tsa
tæɹl	taɹl
gɹɛ	gɹɛ
ɣɛns	gɛns
tsiɹf	tsɪɹf
fins	fins
siɹs	sɪɹs
bɹef	bɹef
noɹf	noɹf
nɹɛs	nɹɛs
ɹuɹk	ɹuɹg
bɹon	pɹon
pɸop	pfob
ɢɔns	gɔns
gɹik	gɹig
bɹifp	pɹɪfp
bɹiɹl	pɹɪɹl
ɣiɹn	giɹn
noɹk	noɹg
ɸop	pob
qus	kʊs
fɹɔst	fɹɔst
ɢɔ	gɔ
luɹ	luɹ
sif	tɪf
lɛɹp	lɛɹp
ɹil	ɹɪl
sek	teg
sɹɛk	sɹɛg
pɸek	pfeg
bɹiɹk	bɹɪɹk
ɔt	ɔt
loɹl	loɹl
lest	lest
tsop	tsop
sɹɛɹn	sɹɛɹn
suns	tuns
nuɹ	nuɹ
ɸœf	pɛf
sik	sɪk
bɹɔp	bɹɔp
lɔf	lɔf
seɹ	teɹ
bɹus	pɹʊs
gɹæɹt	gɹaɹt
sɹip	sɹɪp
nɹel	nɹel
lɹon	lɹon
bɹuɹn	bɹʊɹn
nuɹ	nʊɹ
fens	fens
tsuɹ	tsʊɹ
lɹut	lɹud
ɸœs	pɛs
zefp	defp
zɛns	dɛns
bɹiɹn	pɹiɹn
dɹip	dɹɪp
fɹeɹt	fɹeɹt
sɹuɹs	sɹuɹs
zufp	dʊfp
bɹiɹp	bɹɪɹp
gɹuɹf	kɹuɹf
ɛs	ɛs
dɹɛl	tɹɛl
fæɹt	faɹt
fɹuk	fɹʊg
lɹiɹs	lɹiɹs
gɹuk	gɹuk
sɹɛn	sɹɛn
sɹol	sɹol
xɛɹk	kɛɹg
bɹæp	bɹab
tsæn	tsan
dɹek	dɹek
fɹiɹf	fɹɪɹf
fip	fɪb
ɸøk	pek
qɔst	kɔst
dɹɔk	dɹɔk
sɛ	sɛ
ɢɔp	gɔb
sɹup	sɹʊb
let	led
pɸil	pfil
βust	bust
fiɹk	fiɹk
tsæns	tsans
ɸœfp	pɛfp
ɹin	ɹɪn
siɹn	sɪɹn
pɸɛt	pfɛd
niɹp	niɹp
dɹis	tɹɪs
gɹæɹs	kɹaɹs
sɹuɹk	sɹʊɹg
sen	sen
βoɹk	boɹg
bɹoɹn	bɹoɹn
suɹ	sʊɹ
nuns	nuns
fɹol	fɹol
il	il
lɹuɹt	lɹʊɹd
ɸɶɹl	paɹl
gɹɔs	gɹɔs
βiɹp	biɹb
lɹɔp	lɹɔp
dæɹs	daɹs
loɹk	loɹk
fɹek	fɹek
qut	kud
bɹons	pɹons
fɛt	fɛd
ip	ip
tsit	tsɪt
nɹæp	nɹab
ɸoɹk	poɹk
liɹk	lɪɹg
nɛɹp	nɛɹp
bɹiɹ	pɹiɹ
pɸiɹt	pfiɹd
xeɹt	keɹd
bɹɛns	pɹɛns
gæɹ	gaɹ
niɹt	nɪɹt
zuɹk	duɹg
qot	kod
seɹk	seɹg
oɹs	oɹs
ut	ut
dɹæk	tɹag
ɹef	ɹef
ɣep	gep
snɛst	snɛst
suk	tʊk
nɹɔɹp	nɹɔɹb
sɔɹk	sɔɹk
pɸiɹl	pfɪɹl
sɛɹt	tɛɹd
sɹufp	sɹufp
gæɹt	gaɹt
nok	nok
snun	snun
gɹuk	gɹʊg
gɹuns	gɹʊns
bɹifp	bɹɪfp
gɹæn	gɹan
ɸøɹk	peɹk
la	la
zɔɹt	dɔɹt
lɹɛk	lɹɛg
βøns	bens
dɹop	tɹop
tsu	tsu
qut	kʊt
aɹf	aɹf
gɹɛɹk	kɹɛɹg
nɹos	nɹos
nɹit	nɹɪd
ɹɛf	ɹɛf
liɹp	liɹb
nɔɹp	nɔɹb
dɹefp	dɹefp
gɹæns	kɹans
dɹuns	tɹʊns
tsufp	tsʊfp
pɸonɹen	pfonɹen
lɹeɹzɛns	lɹeɹtɛns
zɛɹlβɔɹk	dɛɹlbɔɹg
dɹɔɹdsuɹf	tɹɔɹtsuɹf
nuɹbpɸiɹk	nuɹppfɪɹg
lɹuflæp	lɹuflap
nɹiɹdæns	nɹiɹtans
dɹɔnsbɹifp	dɹɔnspɹɪfp
sɹibbɹup	sɹɪbpɹup
gɹudɸun	gɹʊdpʊn
qofpɢɔns	kofpgɔns
fuɹgnɹɛst	fuɹgnɹɛst
fimɸust	fɪnpʊst
lɹuɹsbɹof	lɹuɹsbɹof
sɛlsɹɛk	sɛlsɹɛg
soblɹep	soblɹep
bɹeɹfɹoɹs	pɹeɹfɹoɹs
sɹoɹbsiɹ	sɹoɹpsɪɹ
kæbnɹiɹn	kabnɹiɹn
sɹiɹdβok	sɹiɹtbog
zinsoɹs	dintoɹs
ɹilfɔn	ɹilfɔn
setfep	setfeb
dɹufpnɹoɹl	dɹufpnɹoɹl
sɹoblik	sɹoblig
bɹuɹszuk	bɹuɹsduk
qufβœn	kufbɛn
aɹbɸɔn	aɹppɔn
næntsoɹs	nantsoɹs
zɛfpgɹɔt	dɛfpgɹɔd
snæbtsut	snabtsʊt
seɹgdɹeɹt	teɹkdɹeɹd
bɹuɹgbɹun	pɹuɹkpɹun
qulet	kʊled
βɔdlɹoɹk	bɔdlɹoɹk
fɹiɹdɸɶ	fɹiɹtpa
bɹɔɹdɸɔt	pɹɔɹtpɔt
lɹeɹbbɹeɹk	lɹeɹbbɹeɹk
xiftsuɹ	kiftsuɹ
dænsiɹt	dansiɹd
dɹofpdɹeɹp	dɹofpdɹeɹb
dɹɛdgɹof	dɹɛdgɹof
lopɸut	lopfʊd
gɹiklɹot	kɹiklɹod
bɹɔfsɹeɹ	bɹɔfsɹeɹ
fɹiɹgdɹæf	fɹɪɹgtɹaf
dɹipβɶɹl	tɹipbaɹl
lɔmbɹæɹt	lɔnpɹaɹd
ɹidgɹɛɹp	ɹidkɹɛɹp
dɹɛɹsɹost	tɹɛɹsɹost
ɸøfpɸiɹl	pefpfɪɹl
dɹeɹnsæɹn	dɹeɹnsaɹn
ɸugbɹɛp	pugbɹɛp
tsæɢo	tsago
bɹæbbɹik	bɹabbɹɪk
fɹopdɹi	fɹopdɹɪ
bɹæknɹeɹp	bɹaknɹeɹb
gɹeppɸest	kɹeppfest
tsoɹgtsɛn	tsoɹgtsɛn
nodfɔɹp	nodfɔɹp
dɹusæst	tɹusast
gɹotgɹin	kɹotgɹɪn
tsuɹlɢuns	tsʊɹlgʊns
sɹæɹlsa	sɹaɹlta
ɹeɹbxest	ɹeɹpkest
noɹgβuns	noɹkbuns
xɛɹgnɹoɹl	kɛɹgnɹoɹl
ɸɶpdɹin	paptɹin
tseŋxiɹn	tsenkɪɹn
fukɸɶt	fʊkpat
nɹuɹlbɹuk	nɹuɹlbɹuk
xikzoɹ	kikdoɹ
suɹbfɹɔɹl	suɹbfɹɔɹl
foɹfnɹis	foɹfnɹis
xistgɹɛɹt	kistgɹɛɹd
dɹistpɸot	dɹistpfod
bɹɔlfɹok	bɹɔlfɹog
foɹlgɹoɹp	foɹlkɹoɹb
sɹiɹdɹok	sɹiɹtɹok
ɣɛklɹiɹ	gɛklɹɪɹ
bɹigsɔs	pɹigsɔs
ɹɔɹbdɹist	ɹɔɹpdɹɪst
lɹiɹspɸɔɹn	lɹɪɹspfɔɹn
ɹustbyn	ɹustbɪn
ɢoɹltsip	goɹltsib
sugɹæɹl	tʊgɹaɹl
zufsɛp	duftɛb
qoɹbxip	koɹbkib
pɸubbɹit	pfubpɹit
βɶlgɹæɹn	balkɹaɹn
sɹensfɹuɹt	sɹensfɹʊɹd
nitɸɶfp	nitpafp
βœɹbxɛɹs	bɛɹbkɛɹs
fɹæɹgtsoɹt	fɹaɹktsoɹd
dɹiffuɹk	dɹɪffuɹk
gɹikɢoɹl	gɹikgoɹl
dɹæɹdbɹep	dɹaɹdpɹeb
ɹæɹdɣeɹp	ɹaɹdgeɹp
ɹuɹsfɛɹp	ɹʊɹsfɛɹb
gɹiɢuk	kɹɪgug
dɹibnɛn	tɹibnɛn
lɹɛɹnsɔns	lɹɛɹnsɔns
fɹunlɛɹk	fɹʊnlɛɹk
ɢuɹdɸøk	gʊɹdpek
bɹæfgæɹp	bɹafgaɹb
bɹeltsɔt	pɹeltsɔt
ɣiɹgsneɹ	gɪɹgsneɹ
bɹistsnif	pɹistsnif
quntsuɹp	kʊntsʊɹp
ɹessɹup	ɹessɹʊp
fɹuɹbqut	fɹʊɹpkud
βœɹmbɹɔɹk	bɛɹnbɹɔɹg
nɹonlɛɹ	nɹonlɛɹ
gɹiɹdtsɔɹ	kɹɪɹdtsɔɹ
ɹidsæɹf	ɹidsaɹf
tsuɹdnɹifp	tsʊɹdnɹɪfp
tsikxɛt	tsikkɛt
sɛtlɔɹp	sɛtlɔɹp
ɣɛlɹɔɹn	gɛlɹɔɹn
pɸæɹzɛɹk	pfaɹtɛɹg
dɹuɹdbɹæɹt	tɹuɹdpɹaɹt
xisɸip	kispib
nɹuɹdtsiɹp	nɹuɹttsɪɹb
gɹefsnoɹn	kɹefsnoɹn
siŋgɹip	singɹɪb
bɹoɹgɢɔf	pɹoɹggɔf
fɹogbɹɛɹk	fɹogpɹɛɹk
lislɹik	lɪslɹɪg
gɹupzɔst	kɹʊpdɔst
fɹuɹmβop	fɹuɹnbop
gɹuɹnɹɔf	gɹʊɹnɹɔf
tsigpɸik	tsɪgpfik
snuɹdɹuɹ	snuɹtɹʊɹ
βɶɹgsiɹl	baɹktɪɹl
zɔldɹif	dɔldɹif
nɹinsdɹuf	nɹinstɹuf
uɹgtsɛɹt	ʊɹgtsɛɹt
zilgɹæl	dilgɹal
nɛmpɸiɹn	nɛnpfiɹn
nɹubsɛɹl	nɹubtɛɹl
fɹiɹbɹɛɹt	fɹɪɹpɹɛɹt
futnɹofp	fʊtnɹofp
sɛnsdɹɛl	tɛnsdɹɛl
fɹɔɹsdæfp	fɹɔɹsdafp
snɛɹdɹæt	snɛɹdɹat
snænstsuk	snanstsuk
fɛnsnɔk	fɛnsnɔg
nunsβok	nʊnsbok
ɸøstxɛɹn	pestkɛɹn
gɹɛɹsfɹɔk	gɹɛɹsfɹɔk
sɹoɹnlæfp	sɹoɹnlafp
dɹɛstsit	tɹɛsttit
pɸufsɹæɹk	pfʊfsɹaɹg
fɹiɹbbɹe	fɹiɹbpɹe
tægtsuɹ	tagtsuɹ
sɹæɹfsɹust	sɹaɹfsɹʊst
lekbɹis	lekbɹis
zuɹɱfæp	duɹnfab
zuɹzot	dʊɹdod
dɹibɢun	tɹɪbgun
gɹiɹddɹiɹt	kɹiɹttɹɪɹt
gɹiɹbtsin	gɹiɹptsɪn
βuɹgdɹit	buɹktɹɪd
zifpdɹoɹt	difptɹoɹt
læfpgɹuɹ	lafpkɹʊɹ
zuɹdzef	duɹtdef
nɹuɹdɹæɹl	nɹuɹdɹaɹl
bɹɛɹgsɔɹp	pɹɛɹgtɔɹp
quŋgɹɛɹ	kunkɹɛɹ
zifgɹɛɹp	dɪfgɹɛɹb
fɹuɹsgɹæst	fɹuɹskɹast
gɹokfɹeɹl	kɹokfɹeɹl
soɹbsɹefp	soɹpsɹefp
sɛɹfgɹet	tɛɹfkɹed
pɸɛɹbziɹk	pfɛɹbdɪɹk
gɹæɹdɸœk	kɹaɹtpɛg
bɹɛkgɹoɹk	bɹɛkkɹoɹg
bɹæɹldɹet	pɹaɹltɹet
insgɹæɹl	insgɹaɹl
lɹuɹbyɹl	lɹʊɹpɪɹl
gɹɔksɹɛɹp	gɹɔksɹɛɹb
pɸeɹgbɹiɹn	pfeɹgpɹɪɹn
gɹusgɹup	kɹuskɹub
nɔkfɹeɹ	nɔkfɹeɹ
sniggɹɛɹs	snigkɹɛɹs
ɹutzɔk	ɹutdɔk
suɹdsæɹ	suɹtsaɹ
xiɹsqost	kiɹskost
gɹɔsgɹist	gɹɔskɹist
ɢufpsnel	gʊfpsnel
eggɹæɹf	eggɹaɹf
gɹɔtpyl	kɹɔtpɪl
gɹultsip	kɹʊltsɪp
lɹɔggɹɛt	lɹɔggɹɛd
dɹænsɹæst	tɹansɹast
ɢukdɹel	gʊktɹel
sɹɔɹlæs	sɹɔɹlas
bɹiɹgβɶf	pɹɪɹgbaf
læɸof	lapof
gɹæɹdlɹæɹp	gɹaɹtlɹaɹb
luɹdlɛɹk	luɹtlɛɹg
fotnɔɹt	fotnɔɹd
βɶɹlnæfp	baɹlnafp
βuddɹoɹf	buddɹoɹf
pɸɔɹbɹɛns	pfɔɹpɹɛns
snɔfpɸuɹl	snɔfpfʊɹl
ɣefdɹoɹf	geftɹoɹf
nibɹɔ	nɪpɹɔ
βuɹlbɹut	buɹlpɹʊd
gɹogɹiɹt	gɹogɹɪɹd
fɹusgɹɛɹk	fɹʊskɹɛɹg
nɹɛɹdbɹɛ	nɹɛɹtbɹɛ
fostɸɔl	fostpɔl
fɹiɹbɸɶfp	fɹɪɹbpafp
likβɔk	lɪkbɔg
gæɹgbɹons	gaɹgpɹons
bɹoɹddɹɛst	pɹoɹttɹɛst
ɹɛɹdnɔst	ɹɛɹdnɔst
zulɹɔɹt	dulɹɔɹt
bɹɔɹdfɹiɹt	bɹɔɹtfɹiɹt
lɛdlɹost	lɛdlɹost
snoɹgnɹuɹp	snoɹknɹʊɹb
dɹɔlbɹɛk	tɹɔlpɹɛk
bɹopɸæɹp	bɹopfaɹp
gɹɔfpbɹɔɹs	gɹɔfpbɹɔɹs
snuɹgsɹæs	snʊɹgsɹas
bɹonsbɹiɹk	bɹonspɹɪɹg
lɹæɹsæɹp	lɹaɹsaɹb
snɔbsik	snɔbtɪk
fɹuɹdloɹt	fɹʊɹtloɹt
dɹæɹnsnɛs	dɹaɹnsnɛs
snælbɹot	snalpɹot
snotlɹens	snotlɹens
sefpnol	sefpnol
dɹetlɹɛɹk	tɹetlɹɛɹk
fɹæksnuɹn	fɹaksnuɹn
gæɹgdɹɛɹp	gaɹkdɹɛɹp
kæstsɹust	kastsɹʊst
lɹobgɹuɹt	lɹobkɹʊɹd
snutnɹɔk	snʊtnɹɔg
sɹɛpɸul	sɹɛppʊl
nuɹblɹuɹ	nʊɹplɹʊɹ
zɛɹbnɹut	dɛɹbnɹʊt
ɹilɹæɹl	ɹɪlɹaɹl
bɹuɹsgɹu	bɹuɹskɹʊ
ɹitɸɶɹk	ɹitpaɹg
xɛndɹot	kɛndɹot
gɹeɹdqɔt	kɹeɹdkɔt
dɹeɹgβɔɹk	tɹeɹkbɔɹg
βœɹbbɹuɹn	bɛɹbbɹʊɹn
dɹefpyɹk	dɹefpɪɹg
lɹiggæst	lɹɪggast
gɹiɹlfɹoɹs	kɹɪɹlfɹoɹs
snusɔfp	snʊsɔfp
sɹugdɹæɹp	sɹugtɹaɹp
gɹuɹɣit	kɹuɹgit
ɢofpgɹɛɹ	gofpkɹɛɹ
ɢustlɹo	gustlɹo
gɹɛstsɛp	gɹɛsttɛb
gɹiɹbnɔɹp	gɹɪɹpnɔɹb
dɹɛgɹeɹk	tɹɛkɹeɹk
uŋɢuk	ʊnguk
bɹiɹdzɔst	pɹɪɹtdɔst
nuɹbɸuɹp	nuɹbpʊɹp
ɹinssofp	ɹɪnssofp
bɹɔɹdɣɛɹl	bɹɔɹdgɛɹl
kæbɸøk	kabpek
dɹɛɹbβufp	dɹɛɹpbufp
sæɹgbɹep	saɹkpɹep
ɹufpseɹ	ɹʊfpseɹ
lifpɸæns	lifpfans
sɹebsnæɹk	sɹebsnaɹk
ɸɔfppɸɔp	pɔfppfɔb
fɹeɹblɹit	fɹeɹblɹɪd
lɹæɹggɹons	lɹaɹggɹons
bɹɔtdɹust	pɹɔtdɹust
xɛɹglifp	kɛɹglifp
zikβɶɹk	dikbaɹg
fɹoɹlgɹik	fɹoɹlgɹɪg
dɹɛɹbsɹef	dɹɛɹbsɹef
fiɹgxil	fɪɹgkɪl
iɹbɸut	ɪɹbpud
bɹɛfplɹens	bɹɛfplɹens
nɹɔbɢuɹs	nɹɔbguɹs
nɹiɹfzuɹp	nɹiɹfdʊɹp
sitxɛɹn	titkɛɹn
sɹogɹiɹf	sɹokɹiɹf
lɔbnæn	lɔbnan
nɹɛdlæɹt	nɹɛdlaɹt
seɹfnɹiɹn	teɹfnɹɪɹn
gɹilɸɶɹp	kɹɪlpaɹp
ɸɶɹβuɹ	paɹbuɹ
fæɹslɛɹt	faɹslɛɹd
silgɹup	tilkɹʊb
sɹiɹβɶt	sɹɪɹpad
lɹiklɔɹt	lɹiklɔɹt
dɹɛggɹil	dɹɛggɹɪl
dɹiɹdsnɛp	tɹɪɹtsnɛp
nuɹbnɹuɹt	nuɹpnɹʊɹt
dɹigfɹip	dɹɪgfɹɪb
tselɹoɹk	tselɹoɹg
pɸiɹgdɹoɹp	pfiɹkdɹoɹp
sɔɹlfæɹ	sɔɹlfaɹ
sɔgbɹu	tɔgbɹu
bɹɔɹgdɹoɹk	pɹɔɹkdɹoɹg
tsutdɹɔɹ	tsʊttɹɔɹ
bɹæfxiɹl	bɹafkɪɹl
fɹoŋgɹæs	fɹonkɹas
sninit	snɪnit
siɹlfɹust	tiɹlfɹʊst
gɹukbɹuɹf	kɹʊkbɹʊɹf
gɹikdɹɔɹ	gɹiktɹɔɹ
fɛpdɹons	fɛpdɹons
dɹɛbpɸiɹs	dɹɛbpfiɹs
dɹɔɹbzof	tɹɔɹpdof
ɸonssɹɔɹp	ponssɹɔɹp
fɔfpɸɹɛɹp	fɔfpfɹɛɹp
bɹɛɹlsiɹ	pɹɛɹlsɪɹ
fensgɹup	fensgɹub
sæɹssni	saɹssni
ɹɔdβɔk	ɹɔdbɔk
qɔgnɹɔf	kɔgnɹɔf
gɹudsɛ	gɹudtɛ
lɹæɹsgɹok	lɹaɹskɹok
tsebpɸens	tsebpfens
dɹɔtsuɹk	dɹɔtsuɹg
dɹægɹɛ	tɹakɹɛ
bɹiɹfloɹt	bɹɪɹfloɹd
snifpsɹuns	snifpsɹuns
afbyɹp	afbɪɹp
bɹoɹglæf	bɹoɹglaf
ɣiɹgdæst	gɪɹgdast
lɔssnuɹk	lɔssnuɹg
βøssoɹk	bessoɹg
lɹifgɹɛt	lɹifkɹɛd
suɱfɹefp	sʊnfɹefp
sɔɹgβɶn	sɔɹkban
fɛɹlɹɛp	fɛɹlɹɛb
gɹubsneɹk	kɹʊbsneɹk
gɹukbɹo	gɹukbɹo
dɹiɹblok	dɹiɹplog
neɹgsɔs	neɹktɔs
ɹɛlluɹl	ɹɛllʊɹl
pɸæpɢuɹt	pfapgʊɹt
uɹbbɹoɹk	uɹbpɹoɹk
lɹuɹgɹæf	lɹʊɹgɹaf
suɹdɹɛɹk	tuɹdɹɛɹg
βœfsuɹp	bɛftuɹb
zepɸof	depfof
fɹiɹbluns	fɹiɹpluns
xɛgzu	kɛgdʊ
nɹostgɹɛp	nɹostkɹɛb
akquɹp	akkuɹp
bɹusɸɶɹf	bɹʊspaɹf
ɣetqot	getkot
sneβifp	snebifp
tæfsnuns	tafsnʊns
fɔɹgbɹep	fɔɹkbɹep
dɹɔɹgsɛɹk	tɹɔɹgsɛɹg
xiɹsnut	kiɹsnʊt
kæfqust	kafkust
fɹostlu	fɹostlʊ
nefpsnot	nefpsnod
feɹfgɹiɹl	feɹfgɹɪɹl
tsɛspɸuɹt	tsɛspfuɹt
pɸulɸu	pfʊlpu
sɹiɹbsnup	sɹɪɹbsnʊb
lɹuɹssɛfp	lɹuɹstɛfp
βuɹssɹok	bʊɹssɹog
pɸipqɔf	pfipkɔf
sɹæɹndɹɛɹn	sɹaɹntɹɛɹn
fɹɛlnɹiɹl	fɹɛlnɹɪɹl
βufxiɹt	bʊfkɪɹt
lɔlsuɹf	lɔlsuɹf
quɹgbɹop	kʊɹgpɹob
gɹæɹfdɹo	gɹaɹfdɹo
iɹbbɹun	ɪɹppɹʊn
lolɹɛɹf	lolɹɛɹf
nɹɔffɹæɹp	nɹɔffɹaɹp
pɸustβøs	pfustbes
gɹuksuɹk	kɹuksʊɹg
ukbɹu	ʊkbɹʊ
bɹæɹlbɹiɹ	pɹaɹlbɹɪɹ
tsɛgtsæt	tsɛgtsat
gɹuɹdpɸek	gɹuɹdpfeg
ɹɔɹmβuɹt	ɹɔɹnbʊɹt
βussiɹ	bʊstiɹ
dɹɛppɸæns	tɹɛppfans
liɹsfɹe	lɪɹsfɹe
zifpdɹit	dɪfpdɹit
fofpɢuɹ	fofpguɹ
byɹgseɹt	bɪɹkteɹt
ɢɔtlɹɛp	gɔtlɹɛp
feɹlfeɹf	feɹlfeɹf
lɹeslɹiɹn	lɹeslɹɪɹn
abfɹon	abfɹon
fɹɛɹfseɹt	fɹɛɹfseɹd
sneɹstsil	sneɹstsil
tsæpɸɹun	tsapfɹun
tsiggɹɛɹk	tsiggɹɛɹg
fullup	fullub
fɔŋgɹæp	fɔnkɹab
siɹgbɹul	tɪɹgpɹʊl
ziɹgnɹust	diɹgnɹʊst
alpɸuɹs	alpfuɹs
gæɹgpyk	gaɹkpɪg
dɹæŋɢɔɹf	tɹangɔɹf
qoɹgnik	koɹgnɪg
oɹblut	oɹplud
gɹɛptsiɹs	kɹɛptsiɹs
fɛksniɹt	fɛksnɪɹt
sɹuŋquɹk	sɹunkʊɹk
nɹexi	nɹeki
fɹiɹβøl	fɹiɹpel
dɹuɹsnɹɔɹl	tɹuɹsnɹɔɹl
lɹupluɹs	lɹuplʊɹs
sɹɛgzuɹf	sɹɛgduɹf
eɹlpɸɔɹ	eɹlpfɔɹ
dɹuknɔɹt	tɹʊknɔɹt
subluɹf	sʊblʊɹf
fɹuɹdβɶk	fɹʊɹtbag
bɹɔɹsɣe	bɹɔɹsge
ɸøɹdbɹins	peɹtpɹɪns
siɹlsɔf	siɹlsɔf
ɢubnɹæf	gubnɹaf
seɹddɹɔf	teɹtdɹɔf
nɹufsut	nɹʊftut
tsuɹgtsefp	tsʊɹktsefp
sɹiɹmɸuɹs	sɹiɹnpuɹs
bybbɹuɹk	bɪbbɹʊɹk
snɛsttsɛp	snɛsttsɛb
nuɹgɹin	nuɹgɹɪn
bɹæɹdxip	bɹaɹdkib
fofpβiɹs	fofpbiɹs
ɢudfæɹp	gudfaɹb
tsuɹsdɹɛɹk	tsʊɹsdɹɛɹg
seldɹep	teldɹep
siɹsnɹeɹp	sɪɹsnɹeɹb
bɹolbɹæk	pɹolbɹag
dɹæsttsen	dɹasttsen
lɔkgɹen	lɔkkɹen
fɹiɹgsɔn	fɹiɹgtɔn
nɔgbɹefp	nɔgpɹefp
ɸɔxɛɹf	pɔkɛɹf
nɹutfuɹl	nɹutfuɹl
dɹidɢuk	tɹidgʊk
sɛɹslɹel	tɛɹslɹel
ɢubfɹɛp	gubfɹɛp
xiggɹɛs	kigkɹɛs
pɸiɹlβøɹl	pfɪɹlbeɹl
ɣiɹdluɹt	giɹtluɹt
dɹæflɹust	tɹaflɹust
fɹɔlɢot	fɹɔlgod
fɹufpβut	fɹufpbud
zeɹdlɔɹp	deɹdlɔɹp
pyɹdβɔs	pɪɹdbɔs
dɹefpnoɹk	dɹefpnoɹg
ɸœɹlsoɹp	pɛɹlsoɹb
ɸuɹbfoɹt	puɹbfoɹt
nuɹdlɹuf	nʊɹtlɹʊf
kæɹbsɹiɹl	kaɹpsɹiɹl
niɹlɢɔɹp	niɹlgɔɹb
lɛnsɹɛk	lɛnsɹɛg
zuɹsdæɹp	duɹsdaɹp
dɹestβøl	dɹestbel
bɹuɹbdɹef	bɹuɹbtɹef
βiɹdnɹef	biɹdnɹef
pɸɔtgɹoɹf	pfɔtgɹoɹf
fɹeɹlsniɹp	fɹeɹlsniɹb
sɹofpsɹɔt	sɹofpsɹɔt
snuɹdliɹp	snuɹtlɪɹb
pɸiɹfgɹɛ	pfɪɹfgɹɛ
sɔɹmbɹok	tɔɹnbɹog
gɹiknɛ	gɹɪknɛ
quŋgɹoɹp	kunkɹoɹp
zigβœs	dɪgbɛs
lɹiɹdbɹɛt	lɹiɹdbɹɛd
gælsɹɛɹn	galsɹɛɹn
bɹæɹgnuɹk	pɹaɹknʊɹg
nɹotnæk	nɹotnak
nɹefloɹt	nɹefloɹt
zuŋkæp	dʊnkab
fɹuɹbbɹæf	fɹʊɹpbɹaf
ɹoɹbβɔɹk	ɹoɹpbɔɹk
fɔstbɹiɹf	fɔstpɹiɹf
kæfqɔn	kafkɔn
zɔpdɹek	dɔptɹek
dɹiɹlɹok	tɹɪɹlɹok
dɹægsɔɹl	dɹagsɔɹl
nuɹbɹet	nuɹbɹed
ɣeɹgfik	geɹkfɪg
ɢɔfpɸuɹt	gɔfpfʊɹt
tsudlɹɛɹn	tsʊdlɹɛɹn
bɹiɹgsɔt	bɹiɹksɔt
læɹbfol	laɹpfol
bɹeɸœɹl	pɹepɛɹl
gɹustlæɹ	kɹustlaɹ
bɹɔɹlsɹust	bɹɔɹlsɹust
pɸelsɹɛn	pfelsɹɛn
dɹiɹɣik	dɹɪɹgɪk
pɸeɹbsɹil	pfeɹpsɹɪl
sukβuɹp	sukbʊɹb
xɛŋgɹip	kɛngɹib
gɹestsɔn	gɹestsɔn
pɸuɹlbɹiɹk	pfʊɹlbɹɪɹg
ɣeɹsbɹen	geɹspɹen
bɹispɸiɹn	pɹispfɪɹn
ɹoɹbɢuk	ɹoɹbguk
sɔɹbɹok	tɔɹbɹog
nunlɹet	nunlɹed
gɹɛnsbyn	gɹɛnsbɪn
xeɹfpɸe	keɹfpfe
lɔfpɢuk	lɔfpgʊg
lɔtqɔ	lɔtkɔ
zeɹgbɹi	deɹgbɹɪ
pɸɛllit	pfɛllɪd
fɹuɹgtsæɹk	fɹuɹgtsaɹk
nɹiɹlxel	nɹiɹlkel
lunsgɹɛp	lʊnsgɹɛp
lɹɛɹfɹif	lɹɛɹfɹɪf
qɔɹgβɔ	kɔɹkbɔ
suɹnsnuɹt	tʊɹnsnuɹt
sɹudlɹɛɹn	sɹudlɹɛɹn
snuɹdsu	snʊɹtsu
sɛɹbdɹæfp	sɛɹpdɹafp
dɹumbɹɛɹ	tɹunbɹɛɹ
gɹiɹmɸuɹf	gɹɪɹnpuɹf
gɹulif	kɹulɪf
sɔɹdfuɹp	sɔɹdfʊɹp
dɹustnɛfp	dɹustnɛfp
zufsɹoɹl	dufsɹoɹl
nenlit	nenlɪd
fɹiɹbgɹæp	fɹiɹbkɹap
feɹggɹe	feɹggɹe
pɸæfsɹif	pfafsɹɪf
ibzif	ibdif
gɹifɣɛɹk	gɹifgɛɹk
tsɔbsil	tsɔbtɪl
gɹikziɹp	gɹɪkdiɹp
pɸæsttsuɹs	pfasttsuɹs
ɸɔɹbbɹɔst	pɔɹbbɹɔst
sniɹgdɹɔɹt	sniɹgtɹɔɹd
eɹbgɹæɹs	eɹbkɹaɹs
fɹɔɹggɹeɹk	fɹɔɹgkɹeɹk
nɹɔɹdlɔɹt	nɹɔɹtlɔɹd
ɸɔldɹɛɹf	pɔltɹɛɹf
dɹifpsniɹt	dɹɪfpsniɹd
bɹufpgɹoɹ	pɹufpgɹoɹ
siɹdfɹɔɹl	sɪɹdfɹɔɹl
fɹoɹgβuɹp	fɹoɹgbuɹp
nɹogɹɔk	nɹokɹɔk
bɹodsɛɹp	bɹodtɛɹb
dɹuɹdsof	dɹuɹdsof
siβiɹp	tibiɹb
ɹiɹddɹɔɹ	ɹiɹdtɹɔɹ
dɹifplofp	tɹɪfplofp
fæsɹu	fasɹʊ
ɸufpbɹiɹp	pʊfpbɹiɹp
snisttsiɹt	snɪsttsiɹt
βibbɹeɹt	bibbɹeɹt
sifpɸeɹp	tɪfpfeɹp
ɹinslɹep	ɹinslɹep
fegɹɔɹf	fegɹɔɹf
lɹiɹddɹɔɹf	lɹɪɹddɹɔɹf
pɸuɹntæn	pfuɹntan
bɹoldɹæs	pɹoltɹas
tsuɹglɹins	tsuɹklɹɪns
sɹiluɹt	sɹɪluɹt
nɹeɹnnɹust	nɹeɹnnɹust
ɹɛɹlɹiɹp	ɹɛɹlɹiɹb
gɹɛglæɹn	gɹɛglaɹn
dɹoɹbdɹæt	dɹoɹptɹad
pɸifpsɹiɹk	pfɪfpsɹɪɹg
pɸægsnup	pfagsnub
lɹæbgɹut	lɹabgɹud
lɛɹssil	lɛɹstɪl
zinspɸeɹp	dinspfeɹb
feɹmpɸɛɹt	feɹnpfɛɹd
lɔdɹoɹs	lɔtɹoɹs
ziɹspɸɔɹs	diɹspfɔɹs
gɹifpdɹoɹt	kɹifptɹoɹt
tsɛɹstsuɹl	tsɛɹstsʊɹl
dɹɔɹgpɸɔk	dɹɔɹgpfɔk
nɔkfiɹt	nɔkfɪɹt
zɔnspɸæɹt	dɔnspfaɹt
zifɹep	difɹep
ɸitɸøfp	pitpefp
dɹulsnu	tɹulsnu
sɛɹbfep	sɛɹpfeb
lɹuɹbβif	lɹʊɹbbif
qutlɹip	kʊtlɹip
ɹoɹbdɹun	ɹoɹpdɹʊn
nɹodgɹɛɹ	nɹodkɹɛɹ
pɸiɹgsnuɹs	pfiɹksnuɹs
soszot	sosdot
dɹæfpɸɛɹt	tɹafpfɛɹt
ɣɛɹggɹɛɹ	gɛɹggɹɛɹ
gɹudfup	kɹʊdfʊp
bɹɔfqot	bɹɔfkod
xisofp	kɪtofp
dɹiɸɔf	tɹipɔf
fɹɔsdɹɛt	fɹɔstɹɛt
zoɹdgɹæɹl	doɹdgɹaɹl
dɹiɹdbɹiɹt	tɹiɹdbɹiɹt
ɸitɢup	pitgup
sɹæɹnlɹæɹl	sɹaɹnlɹaɹl
zeɹfsnin	deɹfsnin
gɹɛglɹiɹt	kɹɛglɹɪɹt
dɹiɹfbɹuɹf	tɹiɹfbɹuɹf
ɣitsɔt	gɪttɔt
gɹɛtqɔɹt	gɹɛtkɔɹd
seɹgniɹp	seɹkniɹb
gɹuɹgsɹɔk	kɹuɹgsɹɔk
feɹɣeɹt	feɹkeɹt
lɹækqɔt	lɹakkɔt
gæfzɔɹt	gafdɔɹt
neɹlɔɹf	neɹlɔɹf
dɹiɹdbɹæɹp	dɹiɹdpɹaɹb
sullɹɛk	tʊllɹɛg
gɹiɹdkæɹk	gɹɪɹtkaɹg
sɹeɹbyɹt	sɹeɹpɪɹt
dɹossok	dɹossok
ɹuɹbnet	ɹʊɹbnet
bɹɛlsefp	pɹɛlsefp
ziɹdtsuns	diɹdtsʊns
lɹuɹsbɹut	lɹʊɹspɹut
zussoɹk	dustoɹg
tæɹllɔk	taɹllɔg
bɹæɹdbɹi	pɹaɹtbɹɪ
dɹɔgfɔɹp	tɹɔgfɔɹb
dɹuŋgɹæk	dɹungɹag
uɹgtsik	uɹktsik
pɸæɹfbyn	pfaɹfbɪn
ɸœfsit	pɛftɪt
leɹnæɹt	leɹnaɹd
tsænsfɹeɹ	tsansfɹeɹ
untsuɹ	ʊntsuɹ
bɹæɹbtsen	pɹaɹbtsen
dɹuɹldɹɛl	dɹuɹltɹɛl
pɸubdɹɛɹf	pfʊbtɹɛɹf
suɹfeɹp	tʊɹfeɹb
ɹiɹgsɛt	ɹiɹktɛt
dɹɔfɹuɹn	tɹɔfɹuɹn
lollɹɔt	lollɹɔd
fɹiɹbsniɹt	fɹiɹpsnɪɹt
ɣɛɹlsɹiɹp	gɛɹlsɹiɹp
xilsna	kɪlsna
tsuɹblɹot	tsuɹplɹot
xiɹdɢot	kɪɹtgot
bɹitsuk	pɹɪtsʊg
gɹugfɔns	kɹʊgfɔns
sɹoslet	sɹosled
gɹunslɹæl	kɹunslɹal
qunssiɹs	kunstɪɹs
ziblɹeɹl	diblɹeɹl
lɹebfuɹl	lɹebfʊɹl
bɹistsuɹl	bɹɪstsuɹl
snibgɹet	snibkɹet
sɹistdɹons	sɹɪsttɹons
nuflufp	nʊflufp
tsiplɹeɹk	tsɪplɹeɹk
ɹɛstgɹɔɹp	ɹɛstkɹɔɹb
xistgɹist	kɪstgɹist
nɹiɹlsip	nɹiɹlsip
ɣiɹdbɹɔfp	gɪɹtbɹɔfp
gɹuɹdbɹæɹp	kɹʊɹdpɹaɹp
dɹɔtdɹins	dɹɔtdɹɪns
lofpsɹuɹf	lofpsɹʊɹf
ɹofnɹot	ɹofnɹot
ɹebɹoɹ	ɹebɹoɹ
lɹintæp	lɹɪntab
dɹædɸɶɹt	dɹadpaɹd
ɹɔɹflɹuɹ	ɹɔɹflɹuɹ
sɹifpgɹæɹs	sɹifpkɹaɹs
ɹuplɹot	ɹʊplɹod
sugdɹuk	sʊgdɹʊk
sikpɸuɹp	tɪkpfuɹp
fɹesfɹɔt	fɹesfɹɔd
ɸɔɹsniɹt	pɔɹsnɪɹt
gɹuglɹɛn	kɹʊglɹɛn
bɹenssiɹt	bɹenssiɹt
pɸɛbsik	pfɛbtik
bɹoɹɱfɹɛns	bɹoɹnfɹɛns
pɸɔstbɹiɹf	pfɔstpɹiɹf
bɹoɹdfɹɔk	bɹoɹdfɹɔg
nɹoɹgfiɹp	nɹoɹkfiɹp
aɹsnins	aɹsnins
pɸostfɹuk	pfostfɹʊk
nuɹgæɹs	nʊɹgaɹs
lɹiɹɣel	lɹɪɹkel
qosfɹɛns	kosfɹɛns
siɹdsuk	siɹttʊk
qɔfsens	kɔfsens
snubnik	snubnig
βunsɔk	bunsɔk
sekfɹef	tekfɹef
gɹɔlgɹuɹk	kɹɔlgɹuɹk
suɹneɹs	tʊɹneɹs
ɢuɹgnɹæst	guɹknɹast
dɹɔɹfgɹɔk	dɹɔɹfgɹɔk
snɔɹgsɛs	snɔɹktɛs
gɹistæɹt	kɹɪstaɹt
dɹuɹdsɹæp	dɹuɹtsɹap
næfɹup	nafɹʊb
ɣiɹgɸip	gɪɹgpib
dɹilbyɹp	dɹilbɪɹp
nobdɹæt	nobdɹad
tsiɹgɹɛn	tsiɹkɹɛn
tsoɹsβuɹn	tsoɹsbuɹn
dɹuɹŋɢoɹt	tɹuɹngoɹt
gɹɔfbɹɔns	gɹɔfpɹɔns
snifppɸe	snifppfe
pɸɛɹbzol	pfɛɹpdol
ɸɔgɹɛɹl	pɔgɹɛɹl
tsiɹntsons	tsiɹntsons
fɹɛbtæɹ	fɹɛbtaɹ
fufpbyk	fufpbɪg
næɹffæɹt	naɹffaɹt
bɹæfptsut	pɹafptsut
lɹezist	lɹedist
nɹigdɹoɹt	nɹɪgtɹoɹd
sotfeɹs	sotfeɹs
gɹɔfɸup	kɹɔfpʊp
iɹgdɹek	ɪɹgdɹek
sɹikluɹk	sɹɪkluɹk
nɛɹdnuk	nɛɹtnuk
lɹeɹɱfɹop	lɹeɹnfɹob
dɹiɹβɶp	dɹiɹbab
fustβuɹ	fustbuɹ
fuɹfgɹiɹ	fuɹfkɹiɹ
sostzip	sostdib
dɹɛbgæɹf	tɹɛbgaɹf
snæknuɹp	snaknʊɹb
sɹɔɹbgɹɔɹt	sɹɔɹbgɹɔɹt
pɸɛstdæɹk	pfɛstdaɹk
sæɹgtsiɹf	saɹgtsiɹf
bɹɛtsuɹp	bɹɛtsʊɹb
zɛtdɹɔl	dɛtdɹɔl
pɸiɹsɹeɹn	pfiɹsɹeɹn
fiɹbdɹiɹk	fiɹbdɹiɹk
bɹɛɹspɸuɹs	bɹɛɹspfuɹs
βɶɹglefp	baɹglefp
neɹdsɛf	neɹttɛf
βunsbɹiɹp	bʊnsbɹɪɹb
lɹinsæɹt	lɹinsaɹt
niɹnziɹf	nɪɹndiɹf
pɸɔtsi	pfɔtsɪ
lustbɹek	lʊstbɹeg
sɹɛɹsɸuɹt	sɹɛɹspuɹt
lɹuɹbfɹiɹf	lɹʊɹbfɹɪɹf
lɹulɸoɹl	lɹulpoɹl
gɹiɹŋgɹiɹk	gɹiɹngɹɪɹk
bɹeksɔk	pɹektɔk
siɹɣik	sɪɹkig
ɹestsɹuɹt	ɹestsɹuɹd
ɣitfe	gitfe
quɹbsæɹs	kʊɹbsaɹs
bɹoɹgβɶt	bɹoɹgbat
dɹuɹdtsɛk	dɹʊɹdtsɛg
dɹɛbqok	tɹɛbkok
dɹoɹdɹiɹt	tɹoɹdɹiɹt
pɸæptsiɹk	pfaptsɪɹk
sɹɔɹfziɹ	sɹɔɹfdiɹ
dɹugɸøt	tɹʊgpet
tsiɹɛɹk	tsɪɹɛɹg
uɹgdɹiɹp	ʊɹkdɹɪɹp
bɹiɹdnæn	bɹɪɹdnan
næɹlsnek	naɹlsneg
dɹɛsdɹip	dɹɛstɹip
gɹoɹbtsok	gɹoɹptsog
ɹɔbnɹok	ɹɔbnɹog
niklɹin	niklɹɪn
tsiddɹuk	tsidtɹʊg
fɹɔɹfbɹuɹp	fɹɔɹfpɹuɹb
βɶɹftsi	baɹftsɪ
sistgɹæp	sɪstgɹab
bɹoɹsiɹk	bɹoɹsɪɹk
qupɸɹæl	kupfɹal
gɹipβœk	gɹɪpbɛg
bɹigpɸok	bɹɪgpfog
dɹɔɹdgɹæɹn	dɹɔɹdgɹaɹn
sɹoɹlus	sɹoɹlus
siɹnlɹɛns	siɹnlɹɛns
lɹiɹlseɹk	lɹiɹlseɹk
dɹæpdɹæɹk	dɹapdɹaɹk
tsisxil	tsiskil
ɸobɢɔns	pobgɔns
bɹiɹbdɹeɹk	pɹiɹptɹeɹk
tsɔlsnot	tsɔlsnot
nɹɔɹgbɹeɹk	nɹɔɹkbɹeɹk
gɹudɹeɹk	gɹudɹeɹg
lɹɛɹdɸut	lɹɛɹtpʊd
pɸɛɹɔp	pfɛɹɔp
dɹɔlbɹæɹk	tɹɔlbɹaɹg
fɔɹdzin	fɔɹtdin
nɹinsdɹoɹ	nɹɪnstɹoɹ
gɹigɣiɹl	gɹɪggɪɹl
dɹuɹgɹip	tɹʊɹgɹib
dɹɔlbɹuɹs	dɹɔlpɹʊɹs
ɹiɹdbɹæɹk	ɹɪɹtbɹaɹg
fɹigɸøns	fɹigpens
lɹeɹdgæɹn	lɹeɹtgaɹn
tsoɹfɛfp	tsoɹfɛfp
dɹistbɹiɹt	dɹɪstbɹiɹt
xɛɹdkæf	kɛɹtkaf
kæmbɹiɹ	kanbɹiɹ
ɸodnuɹt	podnuɹd
zɛɹdsɛp	dɛɹdsɛb
sɔmpɸɔt	sɔnpfɔd
leɹnlif	leɹnlɪf
gɹofpdɹep	gɹofptɹeb
pyɹbbɹæst	pɪɹbbɹast
ɹufpdɹæɹs	ɹʊfptɹaɹs
tsɛɹbɹæns	tsɛɹpɹans
quɹlβuɹf	kʊɹlbʊɹf
snupsɹoɹs	snupsɹoɹs
pɸiɹlgɹeɹl	pfiɹlgɹeɹl
ziɹbbɹoɹp	diɹbbɹoɹb
gɹefpɢuɹl	gɹefpgʊɹl
pɸɛɹgfɹuɹn	pfɛɹgfɹuɹn
subdɹɔɹn	subdɹɔɹn
snustfos	snʊstfos
zudsɹufp	dudsɹufp
lɔkgɹoɹf	lɔkgɹoɹf
nɹensgɹɛt	nɹenskɹɛd
gɹɔmβok	kɹɔnbog
nɹɔɹsluɹt	nɹɔɹslʊɹd
lɹæfgɹuf	lɹafgɹʊf
gɹɛkdɹop	gɹɛkdɹob
gɹiɹndɹɛt	gɹɪɹntɹɛd
kæɹftsop	kaɹftsop
gɹuɹfloɹp	gɹuɹfloɹb
bɹistpɸit	bɹɪstpfɪd
fæɹsust	faɹsʊst
sussoɹk	tustoɹk
neɹlsɹɔɹp	neɹlsɹɔɹp
ɹɛlnɹæs	ɹɛlnɹas
fɹuɹbkæɹt	fɹʊɹpkaɹd
lesfoɹs	lesfoɹs
lunsdɹɔɹl	lʊnstɹɔɹl
ɣɛtsɔɹk	gɛttɔɹg
bɹiɹbβuns	bɹiɹpbʊns
bɹunsβot	bɹʊnsbod
dæɹdɸœl	daɹtpɛl
ɣifplɹen	gɪfplɹen
gɹuɹnɹuɹp	kɹuɹnɹuɹp
zɔfpsɹɔ	dɔfpsɹɔ
sedɹeɹt	setɹeɹt
gɹensdɹuɹt	kɹenstɹʊɹd
bɹubɹil	pɹupɹɪl
nɔpgɹiɹt	nɔpkɹiɹt
nɹæfsɔt	nɹaftɔd
ɹugdɹoɹs	ɹʊgtɹoɹs
pɸolsut	pfolsʊd
ɸiɹŋxɛt	piɹnkɛt
lɹisdɹeɹp	lɹɪstɹeɹp
uffɹoɹf	ʊffɹoɹf
pɸinsluk	pfinslug
lɹigsoɹt	lɹigtoɹt
βœsnɛs	bɛsnɛs
læpɸøɹf	lappeɹf
fifpnɹuɹk	fifpnɹʊɹk
sɹiɹbɹup	sɹiɹbɹup
snebbɹik	snebpɹɪg
βømpɸins	benpfɪns
suɹgsɹæs	sʊɹksɹas
xipdɹæk	kɪpdɹag
lɹæɹzuɹt	lɹaɹtuɹd
fɹeɹdbɹuɹp	fɹeɹtpɹʊɹb
nɹæɹbɣik	nɹaɹbgɪg
dɹebɹus	dɹepɹus
fudgɹus	fʊdgɹʊs
ɔɹlnip	ɔɹlnɪp
dɹuɹdɹut	tɹuɹtɹʊt
neɹssiɹt	neɹstɪɹd
fudβɶfp	fʊdbafp
nonsnɔɹf	nonsnɔɹf
lɛɹbɸɶs	lɛɹppas
dɹiɹdtsɔk	dɹiɹdtsɔg
gɹeɹbβuk	kɹeɹpbuk
gæksufp	gaktʊfp
sɹɛɹnɹæn	sɹɛɹnɹan
fɹiɹbɸuns	fɹiɹppʊns
lɹækfust	lɹakfʊst
nɹɔɹgbɹen	nɹɔɹgpɹen
ɹeɹgfet	ɹeɹkfet
xeɹdgɹeɹk	keɹdgɹeɹk
nodlɹif	nodlɹif
sefɹɔɹp	tefɹɔɹb
zokbɹæs	dokpɹas
tsuɹsnɛɹl	tsʊɹsnɛɹl
tsiɹlgɹup	tsiɹlgɹup
bɹiɹfdɹæɹt	pɹɪɹftɹaɹt
ɹuɹndɹeɹ	ɹʊɹntɹeɹ
ɢuɹfnɹæɹt	guɹfnɹaɹd
sɹuŋgɹu	sɹʊnkɹu
βofptsit	bofptsɪd
læɹbdɹɛn	laɹptɹɛn
nɹilbɹɛɹf	nɹɪlpɹɛɹf
sɹæssoɹf	sɹassoɹf
læbsɹufp	labsɹufp
ɸuɹdlof	pʊɹdlof
uɹgɹuɹp	ʊɹgɹuɹb
bɹoɹgnɛt	bɹoɹgnɛt
ɢoɹsbɹep	goɹsbɹep
lɛpbyl	lɛpbɪl
bɹeɹgtsæfp	pɹeɹgtsafp
dɹifpsnuk	tɹifpsnuk
zuɹgsɔfp	duɹgsɔfp
gɹeɹdtsæl	kɹeɹttsal
ostzut	ostdʊd
dɹoɹbɹuɹk	tɹoɹbɹuɹk
siksniɹn	siksnɪɹn
lɹɛɹnɹiɹt	lɹɛɹnɹɪɹd
zisxis	diskɪs
sɹænlæp	sɹanlap
gɹɔpsɹil	kɹɔpsɹil
snifnɹuɹk	snifnɹuɹk
bɹiɹgβɶɹf	bɹiɹgbaɹf
lɹuɹstsa	lɹʊɹstsa
dɹestgɹuɹ	tɹestgɹuɹ
xeftsos	keftsos
niɹdɢo	niɹdgo
qostlɹa	kostlɹa
dɹinsdɹoɹk	tɹɪnstɹoɹg
lɹuɹlɸœp	lɹuɹlpɛb
gɹuptsæɹ	kɹʊptsaɹ
nɹupgɹuɹn	nɹupgɹʊɹn
nɛɹɢɔɹk	nɛɹkɔɹk
bykses	bɪktes
zoɹlsip	doɹltɪb
sæfpsɹoɹt	safpsɹoɹd
lɹɔɹddɹuɹ	lɹɔɹdtɹuɹ
gɹufpβœɹp	kɹufpbɛɹb
dɹilɹifp	dɹilɹifp
tsidbɹɛɹt	tsidpɹɛɹt
gɹuɹggɹop	kɹuɹggɹop
bɹistgɹɔfp	bɹistgɹɔfp
ɹɛɹdlens	ɹɛɹdlens
sɹuɹsɹæɹk	sɹuɹsɹaɹg
gæɹbfɹuɹs	gaɹpfɹʊɹs
ɹɛɹdsɛs	ɹɛɹttɛs
pɸiɹfβɔ	pfɪɹfbɔ
seɹlgɹu	teɹlgɹʊ
xebsɹeɹf	kebsɹeɹf
fɛfpɸons	fɛfpfons
lɹuɹlbɹɛp	lɹʊɹlbɹɛb
lodɹæɹn	lodɹaɹn
snulɣɛp	snulgɛp
gɹiɹdsnik	kɹɪɹdsnik
fɹɔɹlsɹifp	fɹɔɹlsɹɪfp
gɹulluns	gɹʊllʊns
susiɹk	sʊtɪɹg
gɹenssnofp	kɹenssnofp
feɹdsnæn	feɹtsnan
seɹŋgɹɛt	teɹngɹɛd
snoβɶɹf	snobaɹf
dɹibdɹe	dɹɪbdɹe
foɹfsɔns	foɹftɔns
xiɹblɹen	kiɹblɹen
zegsɛɹp	degsɛɹb
xeɹndɹuɹn	keɹntɹʊɹn
nepgɹip	nepgɹip
gɹɛbɹus	kɹɛpɹʊs
niɱfiɹk	nɪnfɪɹk
dɹɔɹbɹɛk	dɹɔɹpɹɛg
gɹuɹbxɛl	gɹʊɹpkɛl
sɔɹlgɹɛɹk	sɔɹlkɹɛɹg
nɹissin	nɹɪstɪn
dɹinssniɹn	dɹinssnɪɹn
lutnɹɔf	lutnɹɔf
ɸusdɹɛt	pustɹɛd
nistnɔɹk	nistnɔɹk
suɹlnɹɔ	tʊɹlnɹɔ
bɹoɹslɔɹt	pɹoɹslɔɹd
snibdɹiɹl	snɪbdɹɪɹl
nɹiɹnot	nɹɪɹnot
gɹɔɹnsil	kɹɔɹnsil
sefpgæɹp	sefpgaɹb
dɹæɹsgɹof	dɹaɹskɹof
likæɹk	lɪkaɹg
pɸuɹbtsiɹs	pfʊɹbtsiɹs
fɹwiɹp	fɹʊiɹb
fiɹfliɹp	fɪɹfliɹb
ɹesβiɹk	ɹesbiɹg
endɹufp	entɹufp
fɹɛɹdnɹol	fɹɛɹtnɹol
ɹiɹbgɹik	ɹɪɹbgɹɪg
sogɸøɹk	togpeɹg
zɛfɹuf	dɛfɹʊf
sɹuɹbtsuɹt	sɹʊɹptsuɹd
soɹɔɹt	soɹɔɹd
næɹdɹuɹ	naɹdɹuɹ
fɹiɹlluɹf	fɹɪɹlluɹf
ɢuksɔɹk	gʊktɔɹg
sɹuɹsqɔɹp	sɹuɹskɔɹb
zogɸuɹl	dogpʊɹl
liɹdpɸil	liɹdpfɪl
βɶstnit	bastnɪt
fekbɹoɹt	fekbɹoɹd
bɹiɹdfɹæɹl	pɹɪɹtfɹaɹl
sɹufɸɔf	sɹʊfpɔf
bɹosɹiɹt	bɹosɹɪɹd
gɹoɹgsɛɹl	kɹoɹksɛɹl
dɹiɹgfɹæk	dɹiɹkfɹak
nɹisɹuf	nɹɪsɹuf
qɔɹbnɛɹk	kɔɹbnɛɹg
dæɹltsɛns	daɹltsɛns
fudɹep	fudɹeb
neɹfqɔns	neɹfkɔns
nɹuɹmpɸɔp	nɹuɹnpfɔb
bɹæɹloɹf	pɹaɹloɹf
ɹikgɹiɹk	ɹɪkgɹɪɹg
nɛnsnɹef	nɛnsnɹef
dɹeɹnɹiɹ	dɹeɹnɹiɹ
ziszeɹ	disdeɹ
ɹefpdɹæɹs	ɹefpdɹaɹs
bɹetdɹik	bɹettɹɪk
ɸiɹgzefp	piɹkdefp
bɹosuk	pɹosug
tsɔɹbɹuɹp	tsɔɹbɹʊɹp
βœɹgsuɹp	bɛɹgsuɹb
sɛpsuɹk	sɛptuɹk
bɹɔnsbɹæɹk	bɹɔnspɹaɹk
ɸɔɹsɹef	pɔɹsɹef
ɹɔnssnɛl	ɹɔnssnɛl
dɹiɹlsnæp	dɹiɹlsnap
ɣiɹldɹon	giɹltɹon
næɹsxɛ	naɹskɛ
qɔɹziɹl	kɔɹtiɹl
zufiɹp	dufɪɹp
bɹɔɹgtsik	bɹɔɹgtsik
fɹɛsɔp	fɹɛsɔp
fɹiɹlɢup	fɹiɹlgʊp
ɹiɹblɹu	ɹiɹblɹu
quɹdnɹeɹp	kuɹdnɹeɹb
pɸækpɸut	pfakpfud
sɹofpsæp	sɹofpsab
fɹiɹfɔɹt	fɹiɹfɔɹd
fɹifplæf	fɹifplaf
gɹeɹbbɹel	kɹeɹbpɹel
sneɹfbyɹf	sneɹfbɪɹf
fɹifpsnæn	fɹɪfpsnan
ɹænsɹep	ɹansɹep
nɹoplɹep	nɹoplɹeb
ɹogtæk	ɹogtag
nɛɹgdɹot	nɛɹktɹod
byɹbpɸiɹk	bɪɹppfɪɹk
qɔɹbsɹoɹt	kɔɹpsɹoɹt
gɹunsiɹt	gɹʊntɪɹd
sæɹfbyɹf	saɹfbɪɹf
zɛɹdsut	dɛɹtsud
sɛtlɹɔɹ	tɛtlɹɔɹ
nɹeblɹen	nɹeblɹen
snuɹbgæɹ	snʊɹbgaɹ
nɔzep	nɔdep
fɹopgɹiɹp	fɹopkɹiɹp
gæɹβœs	gaɹbɛs
afbɹus	afpɹus
sifpsut	tifpsʊt
qoɹdxifp	koɹdkɪfp
bɹɛtnɹiɹf	pɹɛtnɹɪɹf
fɹɛɹfɛl	fɹɛɹfɛl
qunsbɹiɹt	kʊnspɹɪɹt
dɹæpniɹ	tɹapnɪɹ
gɹustlɹiɹk	gɹustlɹiɹk
dɹɛstdɹeɹl	tɹɛsttɹeɹl
nɹolɹel	nɹolɹel
sænsliɹt	sansliɹt
nɹistɸøp	nɹɪstpeb
dɹinsfɹun	dɹinsfɹun
βukɣiɹk	bʊkgiɹg
ɔsɹest	ɔsɹest
nɹɛstɣen	nɹɛstgen
pɸænslens	pfanslens
ɸostbɹes	postpɹes
tsɔbfek	tsɔbfek
ɹuɹbɹik	ɹuɹbɹik
fɹelgɹoɹt	fɹelgɹoɹd
βœdgɹiɹp	bɛdgɹɪɹp
dɹimbɹi	dɹɪnbɹɪ
ɸɶfpdɹiɹp	pafpdɹiɹb
snunlup	snunlup
dɹotfæɹt	tɹotfaɹd
nɹɛɹfɹons	nɹɛɹfɹons
ɢodsnuns	godsnuns
suɹdfɔt	tuɹtfɔd
bɹeɹbdɹuɹl	bɹeɹptɹʊɹl
nɹeɹbnɹoɹp	nɹeɹbnɹoɹb
snobzop	snobdop
gɹomβoɹl	kɹonboɹl
ɣiɹbsiɹk	gɪɹbtɪɹg
fɹæɹgsnif	fɹaɹksnif
gɹustfɹis	kɹustfɹɪs
dɹoɹfuɹf	dɹoɹfʊɹf
gɹostsoɹn	gɹostsoɹn
sɹokxep	sɹokkep
dɹuɹgsnuɹp	tɹuɹgsnuɹp
nɛɹgnuɹt	nɛɹgnuɹt
pɸunsβɔf	pfʊnsbɔf
ɛɹdbɹiɹ	ɛɹdpɹiɹ
bɹiflɹeɹk	pɹɪflɹeɹk
gɹubɣiɹf	kɹubgiɹf
iɹgnæɹt	ɪɹknaɹt
ɸɶɹfɣest	paɹfgest
næɹbtsæɹk	naɹbtsaɹk
lɹɔbsnɔf	lɹɔbsnɔf
snizuɹl	snɪdʊɹl
bɹæfpsnop	pɹafpsnob
dɹiɹmpɸæt	dɹiɹnpfad
fɹufbɹip	fɹʊfbɹib
bɹoksest	pɹoksest
xepdɹoɹk	keptɹoɹg
lɹesɹɔf	lɹesɹɔf
lɹiɹsɣɛl	lɹɪɹsgɛl
dɹɛɹllɹik	dɹɛɹllɹɪk
bɹuɹgpɸoɹt	bɹuɹkpfoɹd
dæɹgnifp	daɹgnɪfp
ɣɛɣɛfp	gɛgɛfp
tsæpgɹul	tsapgɹul
βøfpɸɹons	befpfɹons
dɹænsβɔt	tɹansbɔt
zukɸɶfp	dukpafp
bɹænspɸeɹk	bɹanspfeɹg
sɛfgɹɔk	sɛfkɹɔg
lufpsnuɹp	lʊfpsnuɹb
dɹuɹdtsuɹl	dɹuɹttsʊɹl
bybɸun	bɪbpun
dɹunsɢut	tɹʊnsgut
ɸœɹbsnɔɹk	pɛɹbsnɔɹk
dɹæɹnnæɹp	dɹaɹnnaɹb
lɹuŋɣiɹt	lɹʊngiɹd
nɹædɸit	nɹadpit
bɹeɹgbɹuk	pɹeɹkbɹug
ɣɛɹdfɹuɹ	gɛɹtfɹuɹ
fɹidlɹɛɹk	fɹɪdlɹɛɹk
sɹopsnɔɹn	sɹopsnɔɹn
lɹæɹbfet	lɹaɹpfed
ɣebɹɔɹ	gebɹɔɹ
læfpɣiɹk	lafpgɪɹg
logdɹɛfp	logdɹɛfp
bɹɛstpɸes	bɹɛstpfes
gɹunnɹifp	kɹunnɹifp
βuɹgsnof	buɹgsnof
sɔɹsgɹuɹ	sɔɹskɹuɹ
tsisɹil	tsisɹil
byɹdfɹil	bɪɹtfɹil
dɹofpdɹæɹt	tɹofpdɹaɹd
βɶɹgsuɹp	baɹktʊɹb
lɹoɹnsoɹp	lɹoɹntoɹb
snæɹdtsep	snaɹdtseb
lennuɹl	lennuɹl
bɹebdɹop	bɹebdɹop
bybbɹil	bɪbpɹɪl
bɹubzuɹl	pɹubduɹl
pɸænsdɹe	pfanstɹe
ɹækgɹɛɹk	ɹakgɹɛɹk
snipkæɹl	snipkaɹl
dɹiɹgliɹk	dɹɪɹkliɹk
pɸɔnnɹiɹk	pfɔnnɹɪɹk
sopzot	topdot
ɹitlɹɛɹf	ɹitlɹɛɹf
lɹɔnseɹ	lɹɔnseɹ
pɸutnæɹt	pfutnaɹt
snutpɸuns	snutpfʊns
pɸostsnɛfp	pfostsnɛfp
dɹiɹbseɹt	dɹiɹpseɹt
bɹeɹlgæɹs	pɹeɹlgaɹs
sniɹbsniɹp	snɪɹbsniɹb
dɹupɸip	dɹʊppib
bɹiɹlnuns	pɹɪɹlnuns
sneɹdquk	sneɹtkʊk
fostsniɹs	fostsnɪɹs
dænsbɹɔɹp	dansbɹɔɹp
tsɛɹlbɹik	tsɛɹlpɹɪk
sniɹŋgɹeɹk	sniɹnkɹeɹg
ɸøɸøɹk	pepeɹg
lɹɔɹffɹæɹk	lɹɔɹffɹaɹg
tsɛɹdzeɹt	tsɛɹtdeɹt
lɹeɹflɹæf	lɹeɹflɹaf
pɸɛɹdfit	pfɛɹtfɪd
dɹuɹsβœns	dɹuɹsbɛns
sɹuggɹoɹp	sɹugkɹoɹb
dɹeɹdbɹiɹ	tɹeɹdpɹɪɹ
uɹbsɹiɹp	uɹpsɹɪɹp
lɔstgæn	lɔstgan
dɹogdɹɛ	tɹogdɹɛ
qoɹfsɹæn	koɹfsɹan
βuxeɹp	bukeɹp
pɸoɹgsu	pfoɹgtʊ
lubɹɛk	lʊbɹɛk
sɹustbɹuɹp	sɹustpɹʊɹb
ɹiɹziɹt	ɹiɹdiɹt
uɹzɔɹl	uɹdɔɹl
sɹɔɹzet	sɹɔɹtet
bɹɔffɹæk	bɹɔffɹak
dɹɔnsnɛns	dɹɔnsnɛns
gɹustbɹæɹt	kɹustbɹaɹt
βøtsɹuɹt	betsɹuɹt
bɹæbdɹɛt	pɹabtɹɛd
gɹɔndɹɔɹp	kɹɔntɹɔɹp
fɹisxɛɹl	fɹiskɛɹl
fɹɔsuɹ	fɹɔtuɹ
dɹenssæs	tɹenssas
sɹosdɹæp	sɹostɹab
ɸøfpɣit	pefpgid
ɣiɹfdɹɔɹs	gɪɹftɹɔɹs
lɹustseɹn	lɹʊstseɹn
bɹeɹβuk	pɹeɹpʊk
fɔɹgsif	fɔɹgtif
nɹoɹɱful	nɹoɹnfʊl
lɹuɹdzufp	lɹʊɹddʊfp
ɹistbɹɔt	ɹɪstbɹɔt
gɹisbɹuɹp	kɹɪspɹʊɹp
tseɹsɣiɹp	tseɹsgɪɹb
zitlop	ditlob
qusgɹuɹ	kuskɹʊɹ
lɛfæt	lɛfad
ɢudnɹeɹk	gʊdnɹeɹg
læɸuns	lapuns
sɔslɹef	tɔslɹef
fɹuɹbdɹɔt	fɹʊɹpdɹɔt
ɹissoɹs	ɹistoɹs
lɹæɹbɹɔɹp	lɹaɹbɹɔɹp
lonlɹek	lonlɹeg
bɹɔnɹæk	bɹɔnɹag
suɹbsust	sʊɹbsust
lɹɛβøɹp	lɹɛbeɹb
ɸuɹut	puɹud
læɹbgɹuɹs	laɹpgɹuɹs
fɹoŋgɹɛɹk	fɹongɹɛɹg
bɹelɹiɹp	pɹelɹiɹp
dɹesɣiɹk	dɹesgiɹg
lɹeɹsɹuɹp	lɹeɹsɹʊɹb
ɢɔɹnɹɛp	gɔɹnɹɛb
seɹɢok	teɹgok
pyɹdpɸek	pɪɹtpfek
sneɹzɛs	sneɹdɛs
fɹetbyɹp	fɹetbɪɹb
bɹuɹgsiɹk	bɹuɹgtiɹg
gɹɛsɹop	kɹɛsɹob
tsiɹdzop	tsɪɹddop
βɔpdɹik	bɔptɹɪk
ɸɔɹnsnip	pɔɹnsnɪb
snɔɹdnɹit	snɔɹtnɹɪt
dɹæɹlxen	dɹaɹlken
luɹgsoɹk	luɹktoɹg
pɸuɹbfɹest	pfuɹpfɹest
nepxit	nepkit
snɔɹdbɹuɹn	snɔɹdbɹʊɹn
gɹodɹuɹp	gɹotɹʊɹb
tsæsek	tsasek
dɹoɹdɹɔɹ	dɹoɹtɹɔɹ
ɣiɹsdɹis	giɹstɹɪs
lefpβœk	lefpbɛk
nigɹist	nɪkɹɪst
nufpɸɹiɹt	nʊfpfɹɪɹd
βiɹdnɹuk	biɹtnɹʊg
tsutβɶɹp	tsʊtbaɹb
dæksɹɔɹl	daksɹɔɹl
bɹɔnsfoɹn	bɹɔnsfoɹn
ɸɔlβik	pɔlbig
ɸɶkpɸet	pakpfet
snigɸuf	snɪgpʊf
dɹeɹbbɹuɹ	dɹeɹpbɹʊɹ
ɣibβuɹs	gibbʊɹs
bɹæɹbdɹuɹp	bɹaɹbdɹʊɹp
zikdɹust	dɪktɹust
gɹuɹflɛst	gɹuɹflɛst
foɹmpɸuns	foɹnpfʊns
bɹiɹdɸɶk	bɹɪɹtpag
gɹɔbɹe	kɹɔbɹe
dɹɛɹbgɹɛfp	dɹɛɹpgɹɛfp
nɹuɹzot	nɹuɹtot
linsfuɹk	linsfʊɹk
fɹuɹlbɹiɹn	fɹuɹlbɹiɹn
qugtsɔs	kugtsɔs
snɛfgɹut	snɛfgɹut
ɹubsuɹ	ɹubsuɹ
nɹɛfɹɛk	nɹɛfɹɛg
dɹeɹlbɹens	tɹeɹlpɹens
pɸunszɛp	pfʊnsdɛp
iksɹus	iksɹʊs
dɹæksul	dɹaksʊl
ɣitqut	gɪtkud
læɹdlæf	laɹtlaf
lɛŋgɹɔp	lɛnkɹɔp
pɸiɹbɹɛɹt	pfiɹbɹɛɹd
pɸoɹbtsens	pfoɹbtsens
seɹddɹæt	seɹddɹad
fobɹes	fobɹes
fɹiɹgxiɹk	fɹɪɹkkɪɹg
ɸɶɹbgɹɛɹs	paɹbgɹɛɹs
ɸifqus	pifkus
ɸøfbɹɔɹn	pefbɹɔɹn
βɔbbɹuɹk	bɔbpɹʊɹk
dɹæɹfpɸet	tɹaɹfpfet
tseɹbɹɔɹp	tseɹbɹɔɹp
bɹɔfβust	bɹɔfbust
ɸɶɹdfɹeɹp	paɹdfɹeɹb
utsɹuk	ʊtsɹuk
tægɹɔɹf	tagɹɔɹf
lɹitsnuɹk	lɹɪtsnʊɹg
sɹɛɹdtsuk	sɹɛɹdtsuk
fikxiɹl	fikkiɹl
βisɹit	bisɹɪt
pɸefpqɔɹs	pfefpkɔɹs
unsfiɹp	unsfɪɹp
luɹmpyɹp	lʊɹnpɪɹb
qɔfplep	kɔfplep
bɹilsoɹk	bɹɪltoɹg
tsofpgɹun	tsofpgɹʊn
ɸuɹfbɹon	pʊɹfbɹon
bɹoɹsxiɹs	bɹoɹskɪɹs
læɹbgɹuɹt	laɹbkɹuɹt
nɹultsɛɹp	nɹʊltsɛɹp
ɣinsdɹif	ginsdɹif
gɹiklo	kɹɪklo
ɹoɹzoɹf	ɹoɹdoɹf
feɹlnup	feɹlnub
bɹoɹlnæl	pɹoɹlnal
leɹdtsæns	leɹttsans
snɔfbɹil	snɔfpɹɪl
ɹɔtbɹuɹk	ɹɔtbɹʊɹg
gɹotsɹɔl	gɹotsɹɔl
sɔssɔɹl	sɔstɔɹl
βøfppɸiɹk	befppfiɹg
suɹllost	sʊɹllost
kæɹmbɹok	kaɹnpɹok
ɔɹlit	ɔɹlit
gɹumbɹip	kɹʊnpɹɪb
lodxeɹk	lodkeɹg
ɣiɹbsɹɔk	giɹbsɹɔk
gɹuggɹuɹp	kɹuggɹuɹb
simɸuɹn	sinpuɹn
dɹoɹbsɹu	tɹoɹbsɹʊ
niɹglɔɹ	nɪɹglɔɹ
sɹonsnæp	sɹonsnab
fɹuɹdgɹup	fɹʊɹtkɹʊb
gɹɔftsɛt	gɹɔftsɛt
bɹɛɹgtsuɹs	bɹɛɹgtsuɹs
ɹofgɹiɹp	ɹofkɹɪɹp
lubfɹæl	lubfɹal
zislil	dɪslɪl
gɹikdɹoɹ	gɹɪkdɹoɹ
sibβɔɹf	tibbɔɹf
ugɢɔk	ʊggɔg
gɹiɹbɹuɹk	gɹɪɹbɹuɹg
bɹonslɹiɹp	pɹonslɹɪɹp
ɛttsa	ɛttsa
sɹuɹlop	sɹʊɹlop
sulfin	sulfɪn
sɹoɹok	sɹoɹok
ɸuɹdxiɹ	puɹtkiɹ
fɹiɱfɹif	fɹɪnfɹɪf
ɹeɹbxist	ɹeɹbkist
ɹɛtɢɔn	ɹɛtgɔn
zusttsɛns	dʊsttsɛns
lɹɛɹggɹɔp	lɹɛɹkkɹɔp
sepnɹæp	tepnɹap
sistsiɹ	tistsɪɹ
fɹoklɛɹn	fɹoklɛɹn
kætbɹis	katbɹis
snofost	snofost
ɸɶsdɹɔs	pastɹɔs
gɹosneɹp	kɹosneɹb
gɹɔppɸeɹs	gɹɔppfeɹs
gɹibɣifp	kɹibgifp
snɔfɹeɹk	snɔfɹeɹg
tsimβut	tsɪnbut
lɛɹβɶɹp	lɛɹpaɹb
zubpyɹp	dʊbpɪɹp
usgɹeɹs	uskɹeɹs
dɹilβœl	tɹɪlbɛl
bɹeɹdβoɹs	bɹeɹtboɹs
ɹɛɹlgɹɛɹf	ɹɛɹlkɹɛɹf
fɹudɹæɹn	fɹudɹaɹn
gɹuɸɔl	kɹupɔl
efbɹufp	efpɹʊfp
pɸuɹdbɹut	pfʊɹtpɹud
tæɹbbɹuɹt	taɹbpɹuɹt
luplɹuɹt	luplɹuɹt
dɹulβɔp	tɹulbɔp
lɹoɹgɣip	lɹoɹggɪp
suɸuɹl	tʊpuɹl
lɔɹnlip	lɔɹnlib
gɹutlɔɹp	gɹutlɔɹp
bɹeɣi	pɹegi
ofpsɛst	ofpsɛst
ɣepsiɹ	geptɪɹ
ɸœɹlbɹæt	pɛɹlbɹat
bɹɔɹbpɸɛk	bɹɔɹppfɛk
bɹikpɸut	pɹɪkpfut
sɹellɹok	sɹellɹok
ɸugpɸuɹt	pugpfuɹt
gɹisttæfp	gɹisttafp
gɹɛbfɹoɹl	kɹɛbfɹoɹl
neɹfnɹɛɹk	neɹfnɹɛɹg
ɸuɹdɣip	pʊɹdgɪb
gɹɛbɹel	gɹɛbɹel
gɹuɹfbɹe	gɹʊɹfpɹe
nɹistsnɔp	nɹistsnɔb
soɹsnɔɹ	soɹsnɔɹ
zɔɹɱfɔk	dɔɹnfɔg
dɹiɹgsnæl	tɹiɹgsnal
gɹæddɹe	gɹaddɹe
fuɹdsɔp	fuɹdtɔp
βolgɹæfp	bolkɹafp
dɹæɹlɣɛst	tɹaɹlgɛst
dɹɛɹbxit	tɹɛɹbkit
dɹensqɔp	dɹenskɔp
zɛɹdgɹɛt	dɛɹtkɹɛd
sniɹfβuɹs	sniɹfbʊɹs
tsɔnlɹens	tsɔnlɹens
zuɹgɣefp	dʊɹkgefp
fiffɛɹt	fɪffɛɹd
gɹoɹlfɔk	gɹoɹlfɔg
tseɹgdɹufp	tseɹgtɹufp
dɹubsuɹk	tɹubtʊɹg
ziggɹɔk	digkɹɔg
sniɹdtsit	snɪɹdtsɪd
niɹdbɹɔp	niɹtpɹɔb
gɹɔtzet	kɹɔtded
linspɸust	linspfust
bɹugɣɛk	pɹuggɛg
it	ɪit
bɹɔdgɹɔn	pɹɔdgɹɔn
zɔfɹuɹl	dɔfɹʊɹl
nɹednɔɹp	nɹednɔɹp
tsɔsnɹoɹl	tsɔsnɹoɹl
tsɛdbɹoɹk	tsɛdbɹoɹg
snubpyl	snʊbpɪl
βoplin	boplin
quɹbtæf	kuɹbtaf
bɹilɣif	bɹɪlgif
lɹɔɹɢoɹ	lɹɔɹgoɹ
lugnɹɛɹf	lugnɹɛɹf
ɹiɹbsnot	ɹiɹpsnot
dɹusdæɹl	tɹusdaɹl
nɹofbɹut	nɹofbɹut
gɹænnɔk	kɹannɔk
zɛɹfpɸu	dɛɹfpfʊ
gɹiɹgpɸɛt	gɹɪɹkpfɛd
zonsxɛɹt	donskɛɹt
ziɹbbɹuɹf	diɹppɹʊɹf
tsupɸɹæk	tsʊpfɹag
lɹuɹbbɹuɹn	lɹʊɹbpɹuɹn
dɹulsæn	tɹulsan
bɹestleɹl	pɹestleɹl
seɹgxel	seɹgkel
snækfɹit	snakfɹɪd
bɹɛgsniɹ	pɹɛgsniɹ
nɹeɹgsnɛ	nɹeɹgsnɛ
næfpɸɹæt	nafpfɹad
bɹænsxɛt	bɹanskɛd
nɹoɹbtso	nɹoɹptso
letsɔt	letsɔd
sɹɔβɶ	sɹɔba
pɸæddɹop	pfaddɹob
zoɹdfup	doɹtfup
ɣiɹgnɹit	gɪɹgnɹit
ɸɔɹfgɹep	pɔɹfgɹeb
tsullɹop	tsʊllɹob
ɣefpsiɹn	gefptɪɹn
fɹiɸɔɹ	fɹipɔɹ
nɛfdɹist	nɛfdɹɪst
snɛlpɸoɹl	snɛlpfoɹl
iɹssɹop	iɹssɹob
fɹuɹglɹis	fɹuɹglɹis
suddɹeɹf	tudtɹeɹf
foɹgfɹeɹ	foɹkfɹeɹ
gɹuɹfsoɹf	gɹuɹfsoɹf
ɢogloɹ	gogloɹ
nɔɹgdɹu	nɔɹktɹʊ
ɸiɹsbɹoɹk	piɹsbɹoɹg
sɹiɹdlɹɛk	sɹiɹdlɹɛg
lofɣist	lofgist
dɹɛtɸøf	dɹɛtpef
xɛtfɹɛk	kɛtfɹɛg
bɹitβɔs	bɹitbɔs
sufpɢɔt	tufpgɔt
nutnek	nutneg
ɢɔɹfsiɹ	gɔɹftɪɹ
ɹolsiɹs	ɹolsɪɹs
gɹinsnɹel	kɹinsnɹel
gɹuɹdɸɔɹt	kɹuɹtpɔɹt
lɹisfɔɹt	lɹisfɔɹt
gæɹssæɹs	gaɹssaɹs
bɹiɹfzɛn	bɹiɹfdɛn
lɹɔɹdsiɹt	lɹɔɹtsiɹd
bɹolɛ	pɹolɛ
gɹoɹbβœt	kɹoɹbbɛt
βobtsiɹf	bobtsiɹf
dɹutgɹæt	tɹutkɹad
ɹoɹdlɹɛɹt	ɹoɹtlɹɛɹd
pɸæɹbdɹæɹs	pfaɹbdɹaɹs
suɹɹi	sʊɹɹɪ
sɹɔɹgpɸiɹk	sɹɔɹgpfɪɹg
bɹuɹlnɛɹn	pɹuɹlnɛɹn
ɣiɹsbɹæɹn	gɪɹspɹaɹn
dɹɛsson	dɹɛston
ɸuɹgsneɹp	puɹksneɹp
nɹuɹmbyp	nɹuɹnbɪb
snenlɹɛɹt	snenlɹɛɹt
tsolzɔɹt	tsoldɔɹt
dɹiɹdɹɛp	dɹiɹtɹɛp
kænssufp	kanstʊfp
sɹɔfpsnek	sɹɔfpsneg
βiɹflɹeɹt	biɹflɹeɹt
ɸilsnul	pilsnʊl
nonspɸup	nonspfʊb
ɣiɹdtsæɹl	giɹdtsaɹl
xɛɹfsnup	kɛɹfsnup
pɸeɱfu	pfenfʊ
fiɹlniɹp	fɪɹlnɪɹb
gɹuɹbdɹiɹk	gɹuɹptɹiɹg
ɹeɹfβuɹl	ɹeɹfbʊɹl
dɹɛnsgɹɛɹp	tɹɛnsgɹɛɹp
fɹɛɹgsniɹk	fɹɛɹgsnɪɹg
gɹɔɹdɹiɹk	gɹɔɹtɹɪɹk
dɹiɹɱfɹæk	tɹɪɹnfɹag
fɹofpse	fɹofpse
ɸœtdɹuɹl	pɛtdɹuɹl
nɹæɹndɹin	nɹaɹntɹɪn
bɹæɹsbɹo	pɹaɹsbɹo
iɹbfɛs	iɹpfɛs
gɹussɛɹl	kɹustɛɹl
fɹiɹdɸɶɹf	fɹiɹtpaɹf
ɛlæɹp	ɛlaɹb
ɸupɸiɹt	pʊpfɪɹd
βɔɹɣiɹp	bɔɹgiɹp
iɹlɹus	ɪɹlɹʊs
nɔtpys	nɔtpɪs
noɹbsnin	noɹbsnɪn
sefpdɹa	tefptɹa
snɔɹbgɹus	snɔɹbgɹus
bɹæssiɹp	bɹassɪɹp
ɔɹbxef	ɔɹpkef
gɹoɹlnɹuk	gɹoɹlnɹʊg
gɹoɹbnɛt	gɹoɹbnɛt
nɔfgɹot	nɔfgɹod
pɸeɹbpyp	pfeɹppɪb
xɛɹbɹɔns	kɛɹbɹɔns
βoɱfɛɹn	bonfɛɹn
qɔfɹɛɹp	kɔfɹɛɹp
ɔɹbsɹoɹn	ɔɹpsɹoɹn
gɹeɹdbɹɔl	gɹeɹtbɹɔl
siŋɢon	tɪngon
dæstsɹefp	dastsɹefp
gɹɛmbɹæɹp	gɹɛnbɹaɹp
pɸikbyl	pfɪkbɪl
lɹogbɹɛk	lɹogpɹɛg
xɛɹfni	kɛɹfnɪ
ɸøɹlfifp	peɹlfifp
gɹiɹdfiɹp	kɹɪɹtfɪɹp
fɹæɹndɹɛ	fɹaɹndɹɛ
ɢuɹgɹiɹt	gʊɹgɹɪɹd
βupdɹins	bupdɹins
bɹeɹdgɹɔɹn	bɹeɹdgɹɔɹn
snoɹfæɹs	snoɹfaɹs
fɹubgɹɔk	fɹʊbgɹɔk
nɹuɹβut	nɹʊɹbʊt
dɹuɹgɸuk	tɹʊɹkpug
ɹustgɹit	ɹʊstgɹid
dɹiɹsqop	dɹiɹskob
ɹoɹsnuɹp	ɹoɹsnuɹb
dɹusgɹiɹt	tɹuskɹiɹt
nɹiɹfza	nɹiɹfda
fɹɛtbɹes	fɹɛtpɹes
fɹeɹfɢoɹf	fɹeɹfgoɹf
lɹustsɹɛɹl	lɹustsɹɛɹl
bɹoɹbgɹeɹf	pɹoɹpgɹeɹf
fɹuɹsgɹɔɹn	fɹʊɹsgɹɔɹn
seɹβɔɹp	seɹbɔɹp
lɹutsuɹk	lɹʊtsuɹg
tsiɹgɹip	tsiɹkɹip
ɹæɹnnɔst	ɹaɹnnɔst
βuptsep	buptseb
xiɹdgæst	kiɹdgast
lɹɔɹbsil	lɹɔɹpsɪl
fɛɹnnɹist	fɛɹnnɹist
gɹuɹglɹɔp	gɹuɹklɹɔb
lɹɛɹbɹip	lɹɛɹpɹɪb
nuɹɢɔɹp	nuɹkɔɹb
sɹubɣi	sɹubgɪ
byɹgɹɔɹf	bɪɹgɹɔɹf
βɔɹfɣiɹf	bɔɹfgɪɹf
niɹsɸɶp	nɪɹspap
unsɔɹt	ʊntɔɹt
ɹænsfin	ɹansfin
dɹoɹdlɹul	dɹoɹtlɹʊl
fɹiɹnlɹep	fɹɪɹnlɹeb
ɹɔɹbβœt	ɹɔɹpbɛd
nofbɹiɹf	nofpɹiɹf
gɹibbɹop	gɹibbɹop
eɹfsniɹs	eɹfsniɹs
dɹodbɹɔk	tɹodpɹɔg
bɹogzɔ	pɹogdɔ
fufpnek	fufpnek
gɹoɹbgɹok	kɹoɹbgɹok
ɹopbɹis	ɹopbɹis
sɛseɹf	sɛseɹf
uɹgfek	ʊɹkfek
fosgɹɛp	foskɹɛp
nɹæɹlpɸis	nɹaɹlpfis
liɹfgɹon	liɹfkɹon
pɸolfæɹp	pfolfaɹp
sɹæɹgxek	sɹaɹkkeg
dɹopbɹɔn	tɹopbɹɔn
lɔksiɹp	lɔksiɹp
foɹnnæk	foɹnnak
xɛlsuɹ	kɛlsʊɹ
nɹostbɹæɹt	nɹostpɹaɹt
bɹæɹgsɛl	bɹaɹktɛl
ɢostsit	gostsid
nukxɛs	nʊkkɛs
oɹdbɹeɹk	oɹdbɹeɹk
sɹesɣɛɹp	sɹesgɛɹp
gɹokqust	kɹokkʊst
ɸufɸœf	pʊfpɛf
ɣeɹffufp	geɹffufp
bɹetlɹæɹs	pɹetlɹaɹs
nɹægɹɛɹk	nɹagɹɛɹk
foɹbɸuns	foɹppʊns
lɹæftsæk	lɹaftsag
ɢusfeɹp	gusfeɹp
dɹɛɹgbɹifp	dɹɛɹgbɹɪfp
ɹeɹfɹuɹ	ɹeɹfɹʊɹ
sɹædfɔp	sɹadfɔb
lɛɹdgɹɛp	lɛɹdgɹɛp
tsuksɛs	tsuktɛs
tsɛggɹoɹf	tsɛgkɹoɹf
nɹuɹgɹist	nɹuɹgɹɪst
utɸøl	ʊtpel
snɔɹdpɸif	snɔɹtpfif
nɹedpyɹk	nɹedpɪɹk
quɹsɸɶ	kʊɹspa
ɹɛgtson	ɹɛgtson
lɔɹɣip	lɔɹkɪb
ɢɔsdɹæfp	gɔsdɹafp
pɸostβɶns	pfostbans
bɹɛɹdɹok	pɹɛɹdɹog
xɛsfust	kɛsfust
fɹɛkloɹt	fɹɛkloɹt
seɹdlɹæɹs	seɹdlɹaɹs
qɔtɸiɹt	kɔtpiɹd
lɹetfɔɹf	lɹetfɔɹf
gɹiglut	kɹɪglut
nosɹoɹk	nosɹoɹk
dɹɔstnɹɛɹl	tɹɔstnɹɛɹl
gɹænsɸiɹp	kɹanspiɹb
gɹɔɹdxin	kɹɔɹdkin
ɸodɹæns	potɹans
snuɹbtsɔɹs	snuɹbtsɔɹs
kæppɸuɹk	kappfuɹk
bɹostæfp	bɹostafp
kæɹdquf	kaɹdkuf
ɸosdɹæɹt	posdɹaɹt
fɹudgɹɔɹl	fɹʊdkɹɔɹl
zifuɹn	dɪfuɹn
nussnuɹn	nussnuɹn
ɣɛggɹæɹf	gɛggɹaɹf
dɹudsɹɛs	dɹʊdsɹɛs
qoɹmbɹɔ	koɹnpɹɔ
zinlɹuɹt	dinlɹʊɹd
ɣeɹfβoɹp	geɹfboɹp
bɹifptæf	pɹifptaf
fæfliɹ	fafliɹ
fɹɔlsup	fɹɔltub
noɹdsot	noɹdsod
xensɹoɹk	kensɹoɹk
sɛsnek	tɛsnek
leɹfop	leɹfop
soktsus	toktsʊs
tsibsɹek	tsɪbsɹeg
gɹɛdsɔp	kɹɛdsɔb
ɸobgɹɛɹn	pobgɹɛɹn
fɹɛsdɹɛk	fɹɛstɹɛg
snogdɹoɹt	snogtɹoɹt
luɹbsnun	lʊɹpsnʊn
bɹɛɹdsi	bɹɛɹdsi
xekbɹuɹt	kekpɹʊɹt
ɢuɹŋɣɛɹp	guɹngɛɹp
snipβup	snɪpbʊb
sɹiɹllɹɔfp	sɹiɹllɹɔfp
sædɹæk	satɹag
sɹobkæfp	sɹobkafp
ɣillæns	gillans
leɹssuɹk	leɹstʊɹk
zuɹddɹot	dʊɹttɹod
ziɹbɹit	dɪɹbɹɪt
sɹidgɹɛt	sɹɪdgɹɛd
ɸudɹiɹf	pudɹiɹf
bɹuɹgɢuf	pɹʊɹggʊf
snoɹddɹif	snoɹttɹɪf
sninslɹifp	sninslɹɪfp
snubpɸæɹk	snʊbpfaɹg
bɹwøp	pɹueb
dɹæstsɹus	dɹastsɹus
uɹŋqufp	ʊɹnkufp
ɹæszoɹk	ɹasdoɹk
nɹuɹddɹɔfp	nɹuɹddɹɔfp
xiɹmβɔɹk	kɪɹnbɔɹg
litnuɹp	lɪtnuɹp
bɹofpdɹæɹp	bɹofpdɹaɹp
sizɔ	tɪdɔ
nɹiɹgluk	nɹɪɹglʊg
sniɹlβøk	sniɹlbeg
uɹbɹut	ʊɹbɹʊd
βɶɹlsef	baɹltef
sɹensɹoɹp	sɹensɹoɹb
nibbɹot	nibpɹod
βufplɹut	bʊfplɹʊd
gɹiɹdseɹt	kɹɪɹtseɹd
snissuɹs	snistuɹs
tsɛɹŋgɹæɹt	tsɛɹngɹaɹt
lɹonsgɹæɹn	lɹonsgɹaɹn
lɹɔgseɹs	lɹɔgteɹs
snæɹuɹs	snaɹʊɹs
fɹinnɹeɹl	fɹinnɹeɹl
fɹugtæɹt	fɹʊgtaɹd
eɹdpɸiɹp	eɹdpfɪɹp
sitfos	titfos
gɹiɹsnɹiɹs	kɹiɹsnɹiɹs
gɹɛɹfɹɔn	kɹɛɹfɹɔn
dɹoɹgfɹeɹ	dɹoɹgfɹeɹ
gɹuɹdgɹɛɹp	gɹuɹdkɹɛɹb
lesgɹiɹt	leskɹɪɹd
ɸofsoɹ	pofsoɹ
gɹætdɹuɹt	gɹattɹʊɹt
gɹætnɹist	kɹatnɹɪst
funɹun	fʊnɹʊn
ɹeɹbpɸiɹt	ɹeɹbpfɪɹt
tsusnɹæɹt	tsusnɹaɹd
dɹiɹldɹons	dɹɪɹltɹons
βɔfpɸuɹn	bɔfpfʊɹn
ɸusxik	pʊskɪk
fɔɹgsɹiɹt	fɔɹksɹɪɹt
zɛɹgdɹuɹs	dɛɹgdɹʊɹs
βøfsil	beftɪl
sɹuɹgnɹɛns	sɹʊɹgnɹɛns
noɹfɸɶt	noɹfpat
lɹuɹsnæɹk	lɹuɹsnaɹk
dɹiɹfnin	dɹɪɹfnin
bɹiɹdsɹɔn	bɹiɹdsɹɔn
nɹiɹnɹeɹk	nɹiɹnɹeɹk
ɹæbgɹæk	ɹabgɹak
gæbbɹɔt	gabpɹɔd
tsifdɹek	tsɪftɹek
bɹiktsoɹk	bɹɪktsoɹg
pɸuɹfɢuns	pfʊɹfguns
ɹiɹfɹoɹk	ɹiɹfɹoɹk
sɛlbɹɔɹk	sɛlpɹɔɹg
dɹɛɹdzuɹt	tɹɛɹtduɹd
tsoɹfpɸi	tsoɹfpfɪ
dɹæɹnsnup	dɹaɹnsnʊp
ɹigbɹɔɹ	ɹɪgbɹɔɹ
lɹɛnssnɛs	lɹɛnssnɛs
ulnut	ʊlnud
sɔɹdluɹt	sɔɹtlʊɹd
tsɛdsɛɹt	tsɛdsɛɹt
dɹiɹdsɹɛɹl	tɹɪɹdsɹɛɹl
βobɹil	bopɹɪl
dɹɔɹdgɹef	dɹɔɹtgɹef
dɹɔɹdɹet	dɹɔɹdɹet
nidβiɹf	nɪdbiɹf
fɹuɹbɹok	fɹʊɹpɹog
lɹɛɹmbɹot	lɹɛɹnbɹod
ɸɔbkæk	pɔbkag
ɸɔkfek	pɔkfeg
læɹmbɹuɹp	laɹnpɹuɹp
gɹoɹlfɹæp	gɹoɹlfɹab
bɹekgɹɔɹl	pɹekkɹɔɹl
lɹuɹmpɸuns	lɹuɹnpfuns
dɹɛstgɹens	tɹɛstgɹens
zifsɛs	difsɛs
tsæɹbdæɹ	tsaɹbdaɹ
dɹɔɹdɣiɹ	dɹɔɹdgiɹ
ɸɔsttæk	pɔsttak
liɹlgɹup	lɪɹlkɹʊb
siɹllɹoɹl	siɹllɹoɹl
βibɹæp	bipɹab
tsikɣiɹt	tsɪkgɪɹt
lɹiɹdgɹæn	lɹiɹdgɹan
snɔɹɣist	snɔɹkist
bɹunssɹik	bɹunssɹɪk
ɸunsniɹt	punsnɪɹd
dælsnɛp	dalsnɛb
lɹænet	lɹaned
tsustbɹiɹk	tsʊstbɹɪɹk
fɹɛsxiɹn	fɹɛskɪɹn
dɹiɹldɹuɹp	dɹɪɹldɹuɹb
fɹufzis	fɹʊfdis
qɔkgɹul	kɔkgɹul
ɹuɹdsoɹn	ɹuɹtsoɹn
xɛlsɔɹp	kɛlsɔɹb
sipɸɹil	tipfɹɪl
nɹɔdsofp	nɹɔdtofp
lɛffɹufp	lɛffɹufp
sumβøt	tʊnbet
βøgdɹuɹp	begdɹʊɹb
gɹonsgɹel	gɹonskɹel
sniɹgnuɹk	sniɹknʊɹg
nɛlfɹoɹn	nɛlfɹoɹn
ɸizɛɹp	pidɛɹb
gɹimbɹɔns	kɹɪnbɹɔns
sɛɹgdɹil	tɛɹktɹɪl
ɹɔlsɹɔp	ɹɔlsɹɔp
ɹɔɹsdɹeɹk	ɹɔɹstɹeɹk
snɔɹsgɹuɹk	snɔɹskɹʊɹg
feɹdæs	feɹtas
dɹiɹsɹef	tɹɪɹsɹef
liquf	likʊf
fonsbɹæs	fonspɹas
lɹɔknɛɹt	lɹɔknɛɹt
bydɹuɹk	bɪtɹʊɹg
fɹæfpsɹæk	fɹafpsɹag
sniɹdsɹiɹt	snɪɹdsɹiɹt
bɹubfik	bɹubfik
qoɹzeɹn	koɹteɹn
zoβɔɹs	dobɔɹs
βɔfdɹɔt	bɔftɹɔd
dɹɔɹdnɹuɹs	tɹɔɹtnɹʊɹs
eɹddɹil	eɹttɹɪl
gɹulβɶk	gɹʊlbag
ɢɔfɹi	gɔfɹi
fɹeɹdgɹɔl	fɹeɹtgɹɔl
dɹɔɹnɹon	tɹɔɹnɹon
bɹetnoɹk	pɹetnoɹg
βøgɸøt	begped
ɣesseɹs	gesteɹs
feɹgɹiɹn	feɹgɹiɹn
lɹɛtgɹons	lɹɛtgɹons
nɛɹlxep	nɛɹlkep
fofplɹɛɹ	fofplɹɛɹ
ɢuɹfdɹip	gʊɹfdɹɪp
sɛmβœn	sɛnbɛn
gɹibbɹut	gɹibpɹut
fupɸɹɔɹt	fupfɹɔɹt
dɹæɹftsut	dɹaɹftsut
gɹepbɹif	gɹeppɹif
kæfpβot	kafpbot
dɹopɸɹɔ	dɹopfɹɔ
gɹunskæn	kɹunskan
dɹɛnsnɔs	dɹɛnsnɔs
uɹglɹæɹt	ʊɹglɹaɹt
fuɹdbɹit	fuɹtpɹɪd
nɛɹdgɹiɹt	nɛɹtgɹɪɹt
ɸuɹbquɹf	pʊɹbkuɹf
luɹbβoɹ	lʊɹbboɹ
bɹistpɸiɹt	bɹistpfiɹd
qɔɹdsof	kɔɹdsof
tsuɹslɹefp	tsʊɹslɹefp
zussɹen	dussɹen
siɹdpɸens	tiɹdpfens
tsupnɹoɹn	tsʊpnɹoɹn
fɹestgɹist	fɹestkɹist
gɹeɹnɹuɹs	kɹeɹnɹuɹs
lɛɹdɹɛɹk	lɛɹtɹɛɹg
fɹofpdɹuk	fɹofptɹuk
dɹilsɹofp	dɹilsɹofp
bɹuɹɱfɹins	pɹuɹnfɹɪns
siɹggɹust	siɹgkɹust
fɹæɹggɹæk	fɹaɹgkɹag
tsuɹdfɹɔɹn	tsʊɹtfɹɔɹn
sidbɹil	tidpɹil
bɹissɹɛ	bɹɪssɹɛ
nɹɛgɹup	nɹɛgɹʊp
nɔɹbnuɹt	nɔɹpnʊɹd
sissef	sissef
seɹgfɔɹk	teɹkfɔɹk
fɹæɹslɹeɹp	fɹaɹslɹeɹp
ɹinleɹt	ɹɪnleɹd
ɢuɹnzun	guɹndun
ɢuɹglɹuɹp	guɹklɹuɹp
sɹuɹgliɹp	sɹʊɹglɪɹb
ɸoɱfiɹk	ponfɪɹk
bɹɔɹdtsens	bɹɔɹttsens
dɹuɹlɹæɹs	tɹʊɹlɹaɹs
bɹænuɹ	bɹanuɹ
nɹostsok	nɹosttog
liɹbbɹæfp	lɪɹpbɹafp
ɢonspɸit	gonspfit
fɹifɸøs	fɹɪfpes
dɹibɹit	dɹɪbɹit
βuɹgbɹæt	buɹkbɹad
pɸunskæɹp	pfunskaɹb
fɹɛɹmpyt	fɹɛɹnpɪt
eɹdtsɔns	eɹttsɔns
sɹuɹlnuɹk	sɹʊɹlnuɹk
iɹdtæk	ɪɹttak
lunsuɹl	luntuɹl
siɹfbɹun	siɹfbɹun
nɹæɹlze	nɹaɹlde
snɛfpbɹɛɹl	snɛfpbɹɛɹl
βuɹgsoɹs	buɹksoɹs
lɹuɹlbɹut	lɹʊɹlpɹud
dɹiɹlnɹet	dɹiɹlnɹet
sæksɹiɹp	saksɹiɹb
xeffɔt	keffɔt
ɣelfip	gelfib
sæɹzoɹf	saɹtoɹf
pɸɔtxiɹt	pfɔtkɪɹt
sɛɹnnɹæɹs	sɛɹnnɹaɹs
pɸɔfɸiɹt	pfɔfpiɹt
ɢosnɹɔp	gosnɹɔb
byɹggɹɛɹp	bɪɹggɹɛɹb
sɔɹɢuɹk	tɔɹkuɹg
ansɸiɹl	anspiɹl
tsænsfek	tsansfek
ɸoɹdgɹok	poɹtkɹok
dɹiɹsɹæf	dɹɪɹsɹaf
dɹosɹɛɹn	tɹosɹɛɹn
fiɹdɹɛɹs	fɪɹtɹɛɹs
bɹoptsɛp	bɹoptsɛp
lɹibbɹæɹ	lɹibpɹaɹ
fɹeɹlɸɔɹk	fɹeɹlpɔɹg
tsɛɹggɹuɹ	tsɛɹgkɹuɹ
bɹoɹdgɹɔɹs	bɹoɹdkɹɔɹs
nɔnssɹun	nɔnssɹʊn
fɹɔziɹ	fɹɔdɪɹ
bɹɛbdɹæf	bɹɛbtɹaf
zɛnsɢut	dɛnsgud
dɹiklufp	tɹiklufp
siɹgɹek	siɹkɹek
fɹiɹfsuf	fɹɪɹfsʊf
pɸutxeɹp	pfutkeɹb
sɹenssɹɛɹt	sɹenssɹɛɹd
tsiɹdgɹæl	tsiɹdkɹal
pyfpbɹæɹl	pɪfppɹaɹl
tæɹlɹet	taɹlɹed
ɹiɹffek	ɹɪɹffek
sobɣɛt	tobgɛt
βøɹfu	beɹfʊ
nækdɹiɹ	nakdɹiɹ
tsiɹgβiɹl	tsiɹgbiɹl
lɹulust	lɹʊlust
gɹɛdgɹoɹt	gɹɛdkɹoɹt
gɹiɹndɹist	kɹɪɹntɹɪst
fæɹnsul	faɹntʊl
zuɹlβon	dʊɹlbon
uɹdgɹɔ	ʊɹtgɹɔ
zolgɹufp	dolkɹʊfp
sɹæɹggɹul	sɹaɹgkɹʊl
lɹipnɔɹ	lɹipnɔɹ
gɹiggɹofp	gɹɪgkɹofp
siɹbgɹefp	siɹpgɹefp
snæfɣef	snafgef
gæɹdɢu	gaɹdgʊ
gɹidzif	kɹiddɪf
snufsoɹf	snuftoɹf
qupseɹf	kupteɹf
lɹeɹnɹest	lɹeɹnɹest
gɹæɹbɹuns	kɹaɹpɹuns
bɹukfɹɛɹs	pɹukfɹɛɹs
læɹfgɹɔɹf	laɹfkɹɔɹf
neɹfdɹɛp	neɹfdɹɛp
suɹdsɛp	suɹtsɛb
ɹɛlgɹuk	ɹɛlkɹʊk
fɹisdɹist	fɹisdɹɪst
sunsβun	tʊnsbʊn
ɛɹdbɹiɹp	ɛɹdpɹɪɹp
quɹdɢu	kuɹtgu
fiɹdsnɛt	fiɹdsnɛd
lɛɹfɹeɹp	lɛɹfɹeɹp
zisɹuɹp	disɹʊɹb
lɹinsdɹiɹs	lɹinstɹɪɹs
gɹuplop	gɹuplob
ɹodpɸip	ɹodpfib
sofbɹɛst	sofpɹɛst
ɸœbgɹæl	pɛbkɹal
pɸigfɹoɹn	pfigfɹoɹn
siɹlβɔɹ	tiɹlbɔɹ
fiɹbnuns	fɪɹbnʊns
sneɹbliɹp	sneɹpliɹb
bɹuɹlnɹæɹt	bɹuɹlnɹaɹt
bɹubtsul	pɹubtsul
fɹiɹdsnil	fɹiɹdsnil
quɹɱfɹufp	kʊɹnfɹʊfp
pɸiɹŋkæɹf	pfɪɹnkaɹf
fɹæfpzuɹp	fɹafpduɹp
βuɹŋxɛɹp	buɹnkɛɹb
noɹntsɛk	noɹntsɛk
tsoglut	tsoglʊt
tsiggɹuɹ	tsiggɹuɹ
iɹslɹuɹ	iɹslɹuɹ
sɹɔɹsbɹest	sɹɔɹspɹest
dɹæɹzip	tɹaɹtip
lɹæstlɹist	lɹastlɹɪst
isdɹoɹs	ɪsdɹoɹs
sɹopbɹeɹp	sɹoppɹeɹp
βuɹfbɹiɹs	bʊɹfbɹiɹs
neɹbβun	neɹbbʊn
ɹæɹgdɹɛt	ɹaɹktɹɛd
ɹibɸip	ɹɪbpib
sistsifp	tistsɪfp
gɹæpgɹɛt	gɹapgɹɛt
lɹuɹlsnon	lɹuɹlsnon
gɹɛfpsɹuɹs	gɹɛfpsɹuɹs
bɹiɹfeɹt	bɹiɹfeɹd
nɹeɹnɹɔl	nɹeɹnɹɔl
dɹuɹltsɔɹt	dɹuɹltsɔɹt
lɹudsoɹs	lɹʊdtoɹs
bɹæbniɹt	bɹabniɹt
nɹɛɹnzɔɹt	nɹɛɹndɔɹd
ɸœfgɹin	pɛfgɹɪn
βœɹbpɸuɹf	bɛɹbpfʊɹf
dɹuɹfsɹiɹk	dɹʊɹfsɹɪɹk
ɹɛɹbgɹuɹp	ɹɛɹpkɹʊɹb
lɹudziɹl	lɹʊddɪɹl
ɹipɸu	ɹɪpfʊ
gɹeɹssuɹf	gɹeɹstʊɹf
sɹiɹgbɹiɹk	sɹiɹgbɹiɹg
zunstsuɹt	dunstsʊɹd
nɹoɹfzus	nɹoɹfdʊs
ɸukfɹɔt	pʊkfɹɔt
qugɹof	kugɹof
pɸuɹgɹuk	pfʊɹgɹuk
tsɔlɹeɹ	tsɔlɹeɹ
zɛɹbloɹl	dɛɹbloɹl
xiksɹæɹk	kɪksɹaɹg
ɹimɸost	ɹinpost
lɹuɹbɣeɹp	lɹuɹbgeɹp
sɹɔgɣɛɹp	sɹɔggɛɹp
βøɹdɣiɹs	beɹtgɪɹs
foblɹiɹk	foblɹɪɹg
ɹuɹdsɹɔt	ɹuɹtsɹɔt
lɹɛɹbɹeɹl	lɹɛɹbɹeɹl
bɹɔɹfuɹt	bɹɔɹfʊɹd
gɹæɹlɹuɹp	gɹaɹlɹuɹb
gɹibɹit	gɹɪpɹɪt
nɹutgɹun	nɹutgɹʊn
fɔmɸœp	fɔnpɛp
fɹusdɹeɹt	fɹʊsdɹeɹt
sɔluf	tɔluf
βofpɸil	bofpfɪl
dɹuɹgdɹup	dɹuɹgdɹub
sɹustgɹot	sɹustkɹot
ɸuɹsdɹɛk	pʊɹstɹɛg
ɸøpβik	pepbik
dɹinsfɹuɹl	dɹinsfɹʊɹl
bɹeɹdlɹɔɹs	bɹeɹtlɹɔɹs
sikdɹɔt	tɪkdɹɔt
bɹinsxip	bɹɪnskɪp
iɹnɹiɹ	iɹnɹɪɹ
dɹefsɹɛɹn	tɹefsɹɛɹn
bɹoɹffɹuɹk	pɹoɹffɹʊɹg
gɹɔstdɹæst	gɹɔstdɹast
xislɛɹf	kɪslɛɹf
βɶɹdpɸɛɹf	baɹdpfɛɹf
gɹubdɹuɹp	gɹʊbdɹuɹp
sustzɔɹ	tʊstdɔɹ
gɹæɹdfiɹs	gɹaɹdfɪɹs
dɹedgɹifp	dɹedkɹifp
zigbɹun	dɪgbɹun
lɹuɹsbɹæɹp	lɹʊɹsbɹaɹp
bɹusnɔp	pɹʊsnɔb
tsæɹffuɹ	tsaɹffuɹ
pɸæsit	pfatɪd
dɹægbɹɛɹt	tɹagpɹɛɹt
βutdɹet	bʊttɹet
tsæɹgɢuɹ	tsaɹggʊɹ
fɹɔstsnɛt	fɹɔstsnɛt
ɣeɹggɹɛk	geɹgkɹɛg
lɹufluɹn	lɹʊfluɹn
βufɹɛɹl	bʊfɹɛɹl
dæɹgsɹoɹk	daɹgsɹoɹk
sɹedlo	sɹedlo
feɹdnons	feɹtnons
dɹiɹggɹuɹk	dɹɪɹggɹʊɹg
pɸiɹdɸɔfp	pfɪɹdpɔfp
dɹibsnæɹp	dɹibsnaɹp
pɸeɹsnɔt	pfeɹsnɔt
nigɹep	nigɹep
ɣistdɹɔk	gɪstdɹɔg
gɹunsliɹt	kɹʊnslɪɹd
lɹuldɹæɹk	lɹultɹaɹg
tæstbɹiɹk	tastbɹiɹg
siɹdbɹut	sɪɹtpɹut
lɹuddɹɛɹs	lɹuddɹɛɹs
sniɹlsufp	snɪɹltufp
sɔɹfgɹeɹf	tɔɹfgɹeɹf
fɹinnɹɔns	fɹinnɹɔns
dɹuɸof	tɹupof
gɹidfeɹt	kɹɪdfeɹt
zuknen	dʊknen
sebɣep	tebgep
nɹɔɹsɸɔɹp	nɹɔɹspɔɹb
nɹezuɹk	nɹedʊɹk
pygɹok	pɪgɹog
zedsnuk	dedsnʊg
dɹiɹgɣɛ	tɹiɹkgɛ
zɔɹbsɛɹk	dɔɹptɛɹg
lɹɔtzɛl	lɹɔtdɛl
foɹblɹɛɹk	foɹblɹɛɹg
tsiɹgnɹut	tsiɹgnɹʊd
ɸøɹfbɹuɹ	peɹfpɹʊɹ
zɔɹfgɹip	dɔɹfkɹip
pɸiɹlgɹeɹn	pfɪɹlkɹeɹn
læffuɹl	laffʊɹl
luɹgæɹf	luɹgaɹf
nɹuɹdfɹins	nɹuɹtfɹɪns
pɸoɹllɹeɹt	pfoɹllɹeɹt
zofɣis	dofgɪs
leɹbɹɛp	leɹpɹɛb
dɹilsɹuɹn	dɹilsɹʊɹn
nɹiɹstsɛɹt	nɹiɹstsɛɹd
lɹɔtzek	lɹɔtdek
zeɹbβɔst	deɹbbɔst
ɸiɹmbɹuɹk	piɹnpɹʊɹg
gɹiɹgɸuɹs	kɹiɹgpʊɹs
bɹɛɹbɸøɹs	bɹɛɹbpeɹs
gɹɛɹbnɛt	kɹɛɹbnɛd
nɹimbyɹp	nɹinbɪɹb
ɹubfɹuɹt	ɹʊbfɹuɹd
fɹefpbɹins	fɹefppɹɪns
fiɹfɹuɹt	fɪɹfɹuɹt
gɹukgɹo	kɹukkɹo
dægɢɔf	daggɔf
βɶnsɹɔk	bansɹɔg
sɔɹspɸis	tɔɹspfis
suɹdnɹæl	suɹdnɹal
bɹulɹɛɹp	pɹʊlɹɛɹb
ɸultsɛɹt	pultsɛɹt
lɹægpyɹn	lɹagpɪɹn
ɛɹbnɹuɹp	ɛɹbnɹuɹp
fensbɹet	fenspɹed
fɹosɸɶns	fɹospans
lɹɔŋɢop	lɹɔngob
seɹβøl	seɹpel
ɢogæl	gogal
snipnɹut	snipnɹʊt
noɹbseɹn	noɹbseɹn
bɹɛɹdɹil	bɹɛɹtɹil
læstsip	lastsip
figdɹɔfp	figdɹɔfp
snuɹgpyn	snuɹkpɪn
ɹenssæk	ɹenssak
fɛpdɹin	fɛpdɹɪn
dɹifppɸet	tɹɪfppfed
aɹbsɹist	aɹpsɹɪst
ɸisɸøɹt	pispeɹd
sneɹlɹuɹf	sneɹlɹuɹf
dɹuɹniɹt	tɹuɹniɹd
bɹolgɹit	bɹolkɹɪt
nɹɔɹdfɹɔɹt	nɹɔɹdfɹɔɹd
ubpɸeɹk	ubpfeɹg
ɢubɣis	gubgɪs
snulsuɹs	snulsʊɹs
gɹidsnoɹ	kɹɪdsnoɹ
ɢɔgxɛt	gɔgkɛt
ɸøɹdzuɹl	peɹtduɹl
βuɹsnin	buɹsnɪn
dɹɔɹlul	dɹɔɹlʊl
ɹɛlleɹt	ɹɛlleɹd
ɹoɹgpɸuɹs	ɹoɹgpfʊɹs
pɸɔɹggɹuɹs	pfɔɹggɹʊɹs
bɹutleɹp	pɹʊtleɹb
pɸidbɹuf	pfɪdbɹuf
dæɹbfet	daɹpfed
nunuɹp	nunʊɹb
dɹɛfpbɹust	tɹɛfppɹʊst
sɹiɹɛɹl	sɹɪɹɛɹl
lukɸɶst	lʊkpast
dɹɔɹfɣens	dɹɔɹfgens
sɹɔstfɹɛɹk	sɹɔstfɹɛɹg
dɹoɹfsnul	tɹoɹfsnul
gɹɛstdɹof	gɹɛstdɹof
pɸɛstdɹik	pfɛsttɹig
fuɹdfɹuk	fʊɹdfɹug
sɹelsɔl	sɹeltɔl
xɛkfi	kɛkfi
ɹɛɹfgɹɔk	ɹɛɹfgɹɔg
ɢoɹdsɔɹs	goɹtsɔɹs
bɹoɹdniɹk	bɹoɹdnɪɹk
noɹnsnuk	noɹnsnug
snogɸœn	snogpɛn
sugdɹoɹt	tʊgdɹoɹt
tsofpgɹis	tsofpkɹɪs
ibfɹæk	ibfɹag
ɹufptsiɹ	ɹufptsiɹ
dɹeɹdsɔp	dɹeɹdsɔp
sɛgɹen	tɛkɹen
snoɹgbɹæl	snoɹgbɹal
pɸæɹdsɹoɹl	pfaɹdsɹoɹl
bɹɔɹltsæk	bɹɔɹltsag
dɹufplɹɛɹp	tɹʊfplɹɛɹp
seɹsdɹif	seɹstɹɪf
gɹoɹggɹip	kɹoɹkkɹɪb
sopgɹuɹs	sopkɹuɹs
sɹoɹgdɹæɹp	sɹoɹgtɹaɹp
sɹɛlɢɔɹt	sɹɛlgɔɹt
lultsof	lʊltsof
zulgɹot	dulgɹod
gɹiɹnsɹɔp	gɹiɹnsɹɔb
dɹugpyl	tɹugpɪl
ɹoppɸuɹ	ɹoppfuɹ
ɹobsɹɛɹk	ɹobsɹɛɹk
ansloɹt	ansloɹt
qɔɹgzeɹk	kɔɹgdeɹk
bɹeɹbnɹes	bɹeɹbnɹes
aɹlsɹon	aɹlsɹon
βutfɹit	bʊtfɹit
sɹɔsbɹun	sɹɔsbɹʊn
sɹeɹsufp	sɹeɹsufp
bɹiɹbsnɔk	pɹɪɹpsnɔk
snɛɹsɹeɹf	snɛɹsɹeɹf
ɸuɹdsɹist	pʊɹdsɹɪst
ɣifpseɹk	gifpteɹk
ɸuɹgdɹɛp	puɹkdɹɛp
sotβoɹl	sotboɹl
gɹuɹbtsiɹf	kɹʊɹbtsiɹf
lɹiɹbɣin	lɹiɹpgɪn
lɹoɹdliɹl	lɹoɹdlɪɹl
pɸoɹgbɹɔɹk	pfoɹgbɹɔɹk
lunnifp	lunnɪfp
siɹfxit	siɹfkit
dɹuɹddɹæs	dɹuɹtdɹas
gæɹgzɛst	gaɹkdɛst
fɹofptsɔɹ	fɹofptsɔɹ
snæɱfɹik	snanfɹik
bɹiɹlgɹop	pɹiɹlgɹob
tsompɸens	tsonpfens
lætgæs	latgas
tsɔɹdnæɹt	tsɔɹdnaɹt
ɹegfuɹp	ɹegfʊɹb
pɸustlɹet	pfʊstlɹet
ɹɔfpdɹæɹk	ɹɔfpdɹaɹg
soɹdtsut	toɹdtsʊd
fɹoɹgpɸok	fɹoɹgpfog
zɔplɔs	dɔplɔs
dɹɛɹdɢɔɹ	tɹɛɹdgɔɹ
snɛɹlbɹuk	snɛɹlbɹuk
bɹɔfβœp	pɹɔfbɛb
ɸoɹbgɹiɹ	poɹbkɹɪɹ
βudnɹil	bʊdnɹɪl
sɹætβip	sɹatbib
dɹɔnsdɹuɹp	tɹɔnstɹuɹb
gɹinszɛɹ	gɹinsdɛɹ
sɹiɹsup	sɹiɹsʊb
gɹɛɹgsɹuɹt	kɹɛɹksɹuɹt
βoɹgdɹuɹp	boɹkdɹʊɹp
nɹiɹlsnif	nɹiɹlsnif
tæblɛt	tablɛt
sɹæɹnluns	sɹaɹnlʊns
fɹuɹlgɹifp	fɹuɹlgɹifp
pɸuɹnɹæk	pfuɹnɹag
lɹobɹɔns	lɹobɹɔns
βøzɛɹp	bedɛɹb
gɹindɹeɹp	gɹintɹeɹp
fopnɹef	fopnɹef
dɹufdɹons	tɹufdɹons
gɹiknɹɛst	gɹɪknɹɛst
dɹɔŋqɔn	dɹɔnkɔn
bɹædnɔfp	bɹadnɔfp
bɹæfpsɹiɹl	pɹafpsɹɪɹl
snuɹmpɸoɹt	snuɹnpfoɹt
snɔɹdbɹuk	snɔɹtbɹug
zuɹlbɹun	duɹlpɹʊn
sonsgɹæns	sonskɹans
bɹuɹsnip	bɹuɹsnɪb
lotleɹt	lotleɹt
bɹɔlɸup	pɹɔlpup
pɸiɹggɹuk	pfiɹggɹug
sedtæɹs	sedtaɹs
ɸonzuk	pondʊk
lunssɹuf	lunssɹʊf
lɹifpsnel	lɹifpsnel
sɛnslek	tɛnsleg
lɹæɹdɹɛns	lɹaɹdɹɛns
βɔɹgfist	bɔɹkfist
ɣebzɔɹ	gebdɔɹ
siɹβœn	sɪɹpɛn
bɹubsep	pɹubteb
tsiŋgɹiɹp	tsingɹɪɹp
bɹiɹbɢɔl	pɹiɹbgɔl
dɹiɹbsɔns	tɹiɹbsɔns
fɔɹbɣek	fɔɹpgeg
ɛpdɹɔt	ɛpdɹɔt
lɹusɣiɹp	lɹʊsgiɹb
dɹuɹdgɹik	dɹʊɹtgɹɪg
pɸuɹgsɔ	pfuɹgtɔ
ɣessoɹp	gestoɹb
feɹgfɹif	feɹkfɹif
tsɔfptsæk	tsɔfptsag
gɹukzul	kɹukdul
sɛglɔt	sɛglɔd
ɣeɹɣiɹn	geɹgiɹn
nɹɔfpsɹup	nɹɔfpsɹʊb
pydbɹæp	pɪdpɹab
nuɣeɹk	nʊgeɹk
quntsɛfp	kʊntsɛfp
sinssɔɹt	tɪnssɔɹd
soɹdβœɹk	toɹdbɛɹg
bɹuɹgɹefp	bɹuɹkɹefp
nɹɔɹgfɹeɹs	nɹɔɹkfɹeɹs
tsɔnsɹis	tsɔnsɹɪs
ɛftsiɹ	ɛftsiɹ
bɹusnon	pɹʊsnon
loptæɹs	loptaɹs
siɹdβuk	tiɹtbʊg
zosist	dotist
bɹifpdɹɔɹt	pɹɪfptɹɔɹd
xɛɹŋkæk	kɛɹnkag
lɹufgɹɛɹt	lɹufkɹɛɹd
bɹæɹssneɹ	bɹaɹssneɹ
bɹiɹfnɹuɹk	pɹɪɹfnɹuɹg
fiɹfsnɛɹf	fiɹfsnɛɹf
ɢuɹdsnæɹs	guɹtsnaɹs
lɹensdɹins	lɹenstɹɪns
dælfɹef	dalfɹef
ɹæbɹup	ɹabɹup
ɢoɹdsnɛns	goɹdsnɛns
tsiɹnsɛk	tsɪɹnsɛg
lɹifpdɹæf	lɹɪfptɹaf
dɹukfɛn	dɹukfɛn
fustpɸil	fustpfil
fɹɛβɶs	fɹɛbas
dɹæxep	dɹakep
leɹdpɸuɹn	leɹtpfʊɹn
bɹifpɣɛns	pɹɪfpgɛns
lɹefpsɔf	lɹefpsɔf
gɹædsɹo	kɹadsɹo
βɔfpbɹæs	bɔfpbɹas
gɹuɹnnuɹt	gɹʊɹnnuɹt
sneɹldɹeɹp	sneɹltɹeɹp
snuɹddɹok	snuɹdtɹog
xepɣil	kepgɪl
bɹæsbɹɛk	pɹasbɹɛg
leɹnit	leɹnɪt
foɹbzuɹp	foɹpdʊɹp
fɹeɹdnɹi	fɹeɹdnɹɪ
sɛɹɛk	sɛɹɛg
qoɹgfɹup	koɹkfɹʊb
luɹdnɹef	lʊɹtnɹef
bɹɛtpɸuns	pɹɛtpfʊns
gɹiɹgɣɛɹ	gɹɪɹggɛɹ
nifɣeɹk	nifgeɹg
tsoɹbɸos	tsoɹppos
xexɛs	kekɛs
βuɹglɹus	bʊɹklɹʊs
sensɣep	tensgep
pɸetdɹost	pfettɹost
pɸɛɹfdɹip	pfɛɹftɹɪp
nɹigfɹuɹp	nɹɪgfɹuɹb
pɸiɹlqoɹt	pfɪɹlkoɹt
zɔfpɸɔs	dɔfpfɔs
tsebzin	tsebdin
qobbɹip	kobpɹɪp
foɹdgɹist	foɹtgɹɪst
bɹugqons	bɹugkons
zɛɹdgɹiɹs	dɛɹdgɹiɹs
pɸufsik	pfufsɪk
pɸitsɹins	pfitsɹɪns
bɹiɹggɹɛ	pɹɪɹkkɹɛ
siɹnsnif	tiɹnsnif
niɹdɹit	niɹdɹid
zuptsist	duptsist
tseɹfniɹn	tseɹfniɹn
dɹilbɹuɹp	dɹɪlpɹʊɹp
sɹɛtbɹit	sɹɛtbɹid
suɹdsis	tʊɹdtɪs
gɹegsɹæɹs	kɹegsɹaɹs
tsiɹlzik	tsiɹldik
nɹɛɹgnɔn	nɹɛɹgnɔn
ɸotgɹɔl	potkɹɔl
gɹubsɔt	gɹubsɔd
dɹuɹlpɸofp	tɹʊɹlpfofp
bɹɛɹssuf	pɹɛɹssuf
snikluɹn	snɪkluɹn
gɹuɹnun	gɹʊɹnʊn
bɹufpdɹiɹp	pɹʊfpdɹɪɹp
lɔɹdlɹiɹk	lɔɹtlɹiɹg
nɹufnɹoɹf	nɹʊfnɹoɹf
snænsnɹuɹk	snansnɹʊɹk
gɹɛɹdɹæɹt	kɹɛɹdɹaɹt
siŋgɹɛɹs	tingɹɛɹs
lɹɔssɹop	lɹɔssɹop
zespɸuɹp	despfuɹp
gɹiɹgɸiɹs	gɹɪɹgpiɹs
kæɹbgɹu	kaɹpkɹu
qɔɹnnɹif	kɔɹnnɹif
gɹuɹbɹoɹt	gɹuɹbɹoɹt
idɸis	idpis
ɸœbzup	pɛbdʊp
tsoɹsɹis	tsoɹsɹis
ɣistsiɹf	gistsɪɹf
epnifp	epnifp
lɹuksnɔp	lɹʊksnɔb
dɹæβɔfp	tɹabɔfp
tsiɹgfɛɹk	tsiɹgfɛɹk
tsutsiɹ	tsʊttɪɹ
sugsæn	sugsan
fɹudɹoɹt	fɹʊdɹoɹt
fɹætdɹun	fɹatdɹʊn
fɹunnɹɛɹk	fɹunnɹɛɹg
lɹuplɛt	lɹʊplɛd
fɔpɸɹuɹs	fɔpfɹuɹs
dɹɛgsɹæɹl	tɹɛgsɹaɹl
gɹisiɹl	kɹɪtɪɹl
niɹlgɹæɹs	nɪɹlkɹaɹs
nɹeŋgɹæɹf	nɹengɹaɹf
iɹlfæɹk	ɪɹlfaɹg
seɹsβuɹk	teɹsbuɹk
luɹdsnuɹk	luɹtsnʊɹg
dɹɔbtsufp	dɹɔbtsufp
iɹfnɹeɹt	iɹfnɹeɹt
ɢɔɹsnun	gɔɹsnun
lɹɛɹbnɛɹ	lɹɛɹbnɛɹ
ɣiɹndɹep	giɹntɹep
qɔkgɹek	kɔkkɹeg
ɔɹfbɹeɹt	ɔɹfbɹeɹt
nɹænsnɹɛɹs	nɹansnɹɛɹs
bɹæɹssɛɹ	bɹaɹssɛɹ
sefβœp	tefbɛb
bɹæfβɔɹs	pɹafbɔɹs
gɹæɹgxeɹl	kɹaɹkkeɹl
ziɹbɸœɹ	diɹbpɛɹ
nɹogpɸust	nɹogpfʊst
qokbɹeɹt	kokbɹeɹt
tsisɛ	tsisɛ
nɛɹlfɹiɹp	nɛɹlfɹiɹp
bɹidɢup	bɹidgub
gɹænsgɹufp	gɹansgɹʊfp
dɹepdɹost	dɹepdɹost
qubsifp	kubsifp
dɹɛfdɹist	tɹɛftɹist
leɹfsɹuɹp	leɹfsɹuɹp
snuɹbbyp	snʊɹpbɪb
ɸupxeɹ	pupkeɹ
iɹbɸœɹn	ɪɹppɛɹn
sɹiɹgdɹɔɹt	sɹɪɹgdɹɔɹd
sɹɛstfut	sɹɛstfʊd
pɸiɹfzoɹk	pfɪɹfdoɹk
liɹblip	liɹblɪb
dætlip	datlɪb
quɹbpɸiɹk	kʊɹbpfiɹk
ɸœnsɸøɹk	pɛnspeɹk
dɹɛggɹeɹl	tɹɛggɹeɹl
bɹupniɹp	bɹupniɹb
fɹupnɔs	fɹʊpnɔs
fɔblɹef	fɔblɹef
pɸɛbsɹuɹt	pfɛbsɹuɹt
nesis	netɪs
nɹunsfɹuɹk	nɹʊnsfɹuɹk
ɸɶtsnɛl	patsnɛl
dɹusson	tɹuston
fɔsɸɶɹn	fɔspaɹn
bɹɔsnif	pɹɔsnif
dɹobziɹs	dɹobdɪɹs
xistsɹuk	kɪstsɹʊg
tsɔssnoɹk	tsɔssnoɹk
sundæt	tundad
uɹfoɹk	ʊɹfoɹg
tsiɹŋgæt	tsiɹngad
tsoɹspɸi	tsoɹspfɪ
zufgɹul	dufgɹul
bɹogxeɹl	bɹogkeɹl
bɹædɣiɹs	bɹadgɪɹs
eɹlɢot	eɹlgot
bɹæknæt	bɹaknat
bɹoɹgsos	pɹoɹgsos
tsoɹbfɛk	tsoɹbfɛk
lɹɔnssɹæt	lɹɔnssɹat
lɹulɹut	lɹulɹʊt
snuɹbfɹæɹs	snuɹbfɹaɹs
gɹiɹgdɹuɹn	gɹiɹgtɹʊɹn
zedɣit	dedgit
bɹæfɹefp	pɹafɹefp
bɹusdɹu	bɹʊstɹʊ
fɔpgæɹk	fɔpgaɹg
nɹæɹdsɛɹk	nɹaɹttɛɹg
sofbɹifp	sofpɹɪfp
segnɹun	tegnɹʊn
gɹiɹbβost	gɹiɹbbost
bɹæɹdɹɔɹt	bɹaɹdɹɔɹd
næksel	naksel
sukbɹek	sukbɹek
fuldɹuɹt	fultɹʊɹd
βigpɸik	bigpfig
supɸœɹp	suppɛɹp
zɔgɸɔɹp	dɔgpɔɹb
fɔdsnuns	fɔdsnuns
dɹiɹdsek	dɹiɹtsek
dɹɔdsɛɹn	dɹɔdsɛɹn
sɹɔɹbɸit	sɹɔɹppit
xistnɛns	kistnɛns
susloɹs	sʊsloɹs
ɸɶɹbfɹufp	paɹpfɹʊfp
gɹæɹbβuɹf	kɹaɹbbʊɹf
nɹɔnufp	nɹɔnufp
ɹusɣep	ɹʊsgep
lɔfpgɹæs	lɔfpkɹas
sɹugxip	sɹugkib
qɔldɹu	kɔltɹʊ
dɹuɹgfɹut	tɹʊɹkfɹut
ɸiɹntsæɹt	piɹntsaɹt
nɹæɹzɛp	nɹaɹtɛp
bɹiɹdgɹeɹ	bɹiɹtgɹeɹ
snɛɹbzuk	snɛɹbdʊk
βunnɹis	bunnɹis
sɹɛksnæp	sɹɛksnab
nɛtɸɶɹf	nɛtpaɹf
ɹɔɹsɸiɹs	ɹɔɹspiɹs
sæɹndɹuɹt	saɹntɹʊɹd
pɸosgɹuɹf	pfoskɹʊɹf
ɹondæɹs	ɹondaɹs
ɸuŋgɹɔns	pʊnkɹɔns
gɹeliɹs	gɹeliɹs
lɹɔɹo	lɹɔɹo
ɢugsnoɹp	gʊgsnoɹp
ɣinɹus	gɪnɹus
sɛβoɹt	tɛboɹd
βupbɹuɹl	buppɹuɹl
qɔɹdgɹufp	kɔɹdgɹufp
tæɹgsɹifp	taɹksɹɪfp
ɛɹnnæst	ɛɹnnast
tsugnun	tsʊgnun
βonust	bonust
ɣiɹbpɸut	gɪɹppfut
bɹennɹɛp	bɹennɹɛp
tsɔdnɛ	tsɔdnɛ
susɢup	sʊsgup
sɹæɹbgɹiɹs	sɹaɹpkɹiɹs
fɹætlɛl	fɹatlɛl
ɣelɸɶl	gelpal
lɛɹlpɸæk	lɛɹlpfak
akqot	akkot
βiɹdqɔst	biɹdkɔst
lissoɹk	listoɹg
sɹendɹeɹn	sɹentɹeɹn
gɹuɹbsist	gɹʊɹptɪst
dɹæɹlbɹæɹl	tɹaɹlbɹaɹl
nɔstsɹip	nɔstsɹɪb
sneɹɢɔp	sneɹkɔp
sigpɸuk	sɪgpfʊg
suɹfɢun	sʊɹfgʊn
xinsgɹɔɹ	kɪnskɹɔɹ
fuɹŋgɹuɹt	fʊɹnkɹʊɹd
nɹɛnzop	nɹɛndob
ɹiɹbsip	ɹɪɹbsɪb
liɹbnɔt	lɪɹpnɔt
aɹbsuk	aɹbsug
pɸufsɹi	pfufsɹɪ
ɹeɹdlɛp	ɹeɹdlɛp
fɹulɣiɹt	fɹulgiɹd
ɸœksup	pɛksʊb
sossuns	sostʊns
sɹuɹffɛɹp	sɹuɹffɛɹp
ɹunszɔɹn	ɹʊnsdɔɹn
ziɹdsnit	diɹtsnit
tsodbɹiɹp	tsodpɹɪɹb
snɛbnɹit	snɛbnɹɪd
dɹiɹgɹoɹp	tɹɪɹkɹoɹp
fɹuɹsnɛɹs	fɹuɹsnɛɹs
ɸøgnɹost	pegnɹost
lɹigdɹik	lɹigdɹik
niɹbsɛp	nɪɹpsɛp
βufpɸɹiɹk	bufpfɹɪɹg
gɹæsɹiɹs	gɹasɹɪɹs
ɛpbɹiɹp	ɛppɹiɹb
qostnuɹf	kostnʊɹf
dɹuneɹk	tɹʊneɹk
gɹeɹlfuɹt	gɹeɹlfuɹd
ɢuɹsɣil	guɹsgɪl
ɣɛgsɛɹp	gɛgtɛɹb
byɹfnɹifp	bɪɹfnɹɪfp
suɹgβɔl	suɹkbɔl
soɹdɸɔns	toɹtpɔns
zikɣip	dikgib
tsuɹgβuf	tsʊɹgbuf
niɹglɹɔf	nɪɹklɹɔf
dɹuldɹofp	tɹultɹofp
ɢudɣiɹn	gudgɪɹn
ɸøɹgnɛɹs	peɹknɛɹs
ɢɔɹdsɹifp	gɔɹtsɹɪfp
nekfɹa	nekfɹa
fɹifɸuk	fɹifpuk
pɸifsuɹf	pfɪfsuɹf
gɹeɹfnuɹt	gɹeɹfnuɹd
gæquf	gakuf
ɣeɹsɛ	geɹsɛ
snifpɸɹin	snɪfpfɹɪn
foɹdsnoɹt	foɹtsnoɹt
gɹæɹggɹɛn	kɹaɹgkɹɛn
nokfɹep	nokfɹep
bɹuɹgsuf	pɹuɹktʊf
tsuqut	tsʊkud
tsæɹsfiɹs	tsaɹsfiɹs
sɹinæɹt	sɹinaɹd
aɹgɹest	aɹgɹest
ɢufluɹs	guflʊɹs
tsɔɹdgɹiɹp	tsɔɹtgɹɪɹp
ɸoɹbtsɔɹf	poɹptsɔɹf
noɹbnɹuk	noɹpnɹʊg
ɸuɹbdɹuɹt	puɹbdɹuɹt
bɹiɹddɹɔl	bɹɪɹddɹɔl
xɛnsist	kɛnsist
zuɹbsɹil	dʊɹbsɹɪl
bɹestbɹiɹk	pɹestpɹɪɹk
nɹɛsbɹuɹf	nɹɛsbɹʊɹf
zɛɹlsɹeɹ	dɛɹlsɹeɹ
tsɛsdɹuɹf	tsɛstɹʊɹf
dɹoɹggɹɛɹt	dɹoɹgkɹɛɹd
qɔɹndɹit	kɔɹntɹɪt
gɹuɹggɹeɹf	gɹʊɹgkɹeɹf
ɹeɹgnɹæfp	ɹeɹknɹafp
sɹutbɹot	sɹʊtbɹod
tsɔɹbsɹeɹn	tsɔɹbsɹeɹn
ɸiɹfsest	piɹfsest
lɛɹbfæt	lɛɹbfad
ɹilɸøl	ɹilpel
nistfɹut	nɪstfɹut
fiɹggɹof	fiɹgkɹof
ɹɔɹgfɹɔɹt	ɹɔɹkfɹɔɹt
fipsɛ	fiptɛ
lɛtβot	lɛtbod
fɹiɹgɹun	fɹiɹkɹʊn
bɹɛɹgɹeɹk	pɹɛɹgɹeɹk
nɹiɹgxɛ	nɹiɹgkɛ
fæɹnlɹuns	faɹnlɹʊns
lɹekbɹɛɹp	lɹekbɹɛɹb
ubzit	ubdid
pɸɔɹsdɹik	pfɔɹstɹig
βøɹddɹɔɹ	beɹtdɹɔɹ
sɔɹgpɸeɹp	sɔɹkpfeɹb
bɹiffiɹn	pɹɪffɪɹn
pɸɔɹddɹus	pfɔɹttɹus
sinnɹiɹt	sinnɹɪɹt
dɹɔɹgβuk	dɹɔɹgbug
bɹuɹgfɹot	pɹuɹgfɹot
dɹɔsɛp	dɹɔsɛp
nɹɔllik	nɹɔllɪg
dɹuzɛɹt	tɹʊdɛɹd
pɸuɹsfɹuɹl	pfʊɹsfɹʊɹl
lɹosneɹn	lɹosneɹn
gɹostpɸif	kɹostpfif
dɹuslɹɔɹk	dɹʊslɹɔɹg
ɣeplɹæɹl	geplɹaɹl
lɛɹmbɹɛɹs	lɛɹnbɹɛɹs
ɹɔstlus	ɹɔstlus
iɹbbɹɛɹn	iɹpbɹɛɹn
uɹggɹuf	ʊɹkkɹuf
βisqoɹl	biskoɹl
gɹoɹssɹefp	kɹoɹssɹefp
fɹɔtsnuɹ	fɹɔtsnʊɹ
ɸuɹbsɛɹf	pʊɹbtɛɹf
feɹddɹɔɹp	feɹdtɹɔɹb
lɹæppɸun	lɹappfʊn
nɹennæf	nɹennaf
pɸiɹgsoɹk	pfiɹgsoɹk
sɹɔxeɹs	sɹɔkeɹs
dɹæɹfsnɔk	tɹaɹfsnɔg
ɸɶɹddɹuf	paɹddɹuf
ɣɛgɹæɹt	gɛkɹaɹt
sneɹgpɸuɹt	sneɹgpfʊɹt
gɹoɹgnɹa	kɹoɹknɹa
βugpɸuɹs	bugpfʊɹs
siɹgsɔk	siɹgtɔk
bɹɛslɹɛɹl	bɹɛslɹɛɹl
fuɹbpyɹn	fʊɹppɪɹn
bɹiɹzɛɹl	bɹɪɹtɛɹl
sneɹblɹæɹp	sneɹplɹaɹb
ɢɔɸøp	gɔpep
tsuplæn	tsuplan
lɔsɣɛp	lɔsgɛp
seɹdbɹiɹt	seɹtpɹiɹd
siɹslin	tɪɹslin
sɹæɹfɢok	sɹaɹfgog
loɹndɹɔp	loɹndɹɔb
zuɹgluɹk	dʊɹglʊɹk
gɹɔszis	kɹɔsdɪs
pɸuɹlæɹk	pfʊɹlaɹk
næɹgɣɛt	naɹggɛd
fɹifpβust	fɹifpbust
lɛɹgfɹit	lɛɹkfɹɪt
gɹɔɹsgæɹs	kɹɔɹsgaɹs
lɹosbɹæst	lɹosbɹast
dɹunssɹens	dɹʊnssɹens
ɸøɹgkæɹk	peɹgkaɹk
dɹɛɹdlof	tɹɛɹdlof
ubɢuɹf	ubgʊɹf
βukbɹuɹk	bʊkpɹuɹk
dɹɛɹbɢɔk	dɹɛɹbgɔk
sɛkfɹɔp	tɛkfɹɔb
bɹifsɹɛɹ	bɹifsɹɛɹ
isbɹɔt	ɪspɹɔt
sæɹgfop	saɹgfob
bɹuknɹɛt	bɹʊknɹɛt
bɹeɹgdɹɔɹn	pɹeɹgtɹɔɹn
fɔlsɛk	fɔlsɛg
feɹlgɹis	feɹlgɹɪs
dɹæɹgquɹp	tɹaɹgkʊɹp
zoɹβok	doɹbog
ɸɶɹlsɹeɹf	paɹlsɹeɹf
bɹensiɹt	pɹensiɹd
ɸufdɹoɹk	pufdɹoɹg
fɔsiɹp	fɔtiɹb
uttsɔɹp	ʊttsɔɹp
fesup	fetʊb
ɸøndɹɛl	pentɹɛl
sisttsefp	tisttsefp
osɹep	osɹep
bɹomɸɔɹt	pɹonpɔɹd
næstnist	nastnist
ɸɶɹbɸɔɹs	paɹbpɔɹs
loɹdsok	loɹdsog
ɹɛɹgfok	ɹɛɹkfog
zuɹmɸoɹl	dʊɹnpoɹl
sɹænsiɹp	sɹansɪɹp
nekqoɹf	nekkoɹf
ɣinsbɹɔɹk	ginspɹɔɹk
nobfɹæɹf	nobfɹaɹf
qokgɹup	kokkɹub
ɸunsgɹiɹ	pʊnsgɹiɹ
tsɔɹnsu	tsɔɹnsʊ
snoɹlbɹɛɹp	snoɹlbɹɛɹp
dɹæɹbdɹuɹp	dɹaɹptɹʊɹp
sɹiɹɱfɹul	sɹɪɹnfɹʊl
bɹossɹeɹt	pɹossɹeɹt
loɹsɸœn	loɹspɛn
snussɹɔɹs	snʊssɹɔɹs
tsesgɹæɹt	tseskɹaɹd
dɹɛɹgbɹɛns	tɹɛɹgbɹɛns
uɹnsɹæɹt	ʊɹnsɹaɹd
ɣeɹffek	geɹffeg
dɹustquk	dɹustkuk
ɹɔstzoɹl	ɹɔstdoɹl
snuɹdpɸiɹt	snuɹtpfɪɹd
luɹlpɸɔk	lʊɹlpfɔk
fuɹssɹet	fʊɹssɹed
gɹɛfpɸɹik	kɹɛfpfɹik
nɹefnɹɔk	nɹefnɹɔk
sufpβɔf	tʊfpbɔf
lɛbgɹul	lɛbgɹʊl
iɹfβuk	iɹfbʊg
næɹfbɹɔns	naɹfbɹɔns
snufpsnɛɹ	snufpsnɛɹ
suɹgβœp	suɹgbɛp
dɹefpbɹa	tɹefppɹa
lɹoɹggɹuɹf	lɹoɹgkɹuɹf
dɹoɹdbɹæt	dɹoɹtbɹad
fɹinsdæɹf	fɹɪnsdaɹf
fɹudpɸæf	fɹʊdpfaf
zeβœp	debɛb
sɛɹlsef	tɛɹltef
ɹæɹnifp	ɹaɹnɪfp
sɹiɹfɹɛp	sɹiɹfɹɛb
nɹutleɹt	nɹʊtleɹt
fɹusbɹis	fɹʊspɹis
bɹiɹsgɹuɹl	bɹɪɹskɹʊɹl
xetnɹip	ketnɹib
nɹimpɸul	nɹinpfʊl
ɢuɹgfɹiɹp	guɹkfɹiɹb
noɹbsist	noɹptist
fɹuɹdfɹil	fɹuɹdfɹil
nigɢɔk	nɪggɔk
gæksɹut	gaksɹʊd
bɹistdɹɛɹf	pɹɪsttɹɛɹf
bɹɛgtses	pɹɛgtses
fɹidfɹons	fɹidfɹons
fiɹmbɹut	fɪɹnbɹʊt
nɔɹgtæs	nɔɹktas
fuɹbbɹuɹs	fʊɹbbɹuɹs
xegsɛp	kegsɛb
ɹɛnsles	ɹɛnsles
sæɹbsɹefp	saɹbsɹefp
xɛssɔt	kɛssɔd
tækniɹk	takniɹk
βupnik	bʊpnɪg
dɹɔgsot	tɹɔgsot
ansziɹp	ansdiɹb
ɹubfip	ɹʊbfip
pɸuɹnsɹɛt	pfuɹnsɹɛt
seɹnsef	teɹnsef
ɸœɹbquɹp	pɛɹbkuɹb
bɹiɹgpɸuɹt	pɹɪɹkpfuɹt
quɹnlɹɔɹk	kʊɹnlɹɔɹk
ɹæɹbsneɹt	ɹaɹbsneɹt
dæɹglɛɹp	daɹglɛɹp
bɹiɹbgɹɛs	bɹɪɹpkɹɛs
gɹimbɹɛk	kɹinbɹɛk
ɢuɹbgɹɔp	guɹbkɹɔp
fibtsuɹs	fɪbtsuɹs
nɔnɹɔɹn	nɔnɹɔɹn
gɹubbɹɛs	kɹubpɹɛs
ɸɶfppyt	pafppɪt
loksist	loktist
finlɹiɹp	finlɹiɹb
ɹɔɹgdɹit	ɹɔɹgdɹit
sɹiɹlquɹn	sɹɪɹlkuɹn
bɹistzoɹ	bɹistdoɹ
gɹeɹbβut	kɹeɹpbʊd
bɹuɹftsefp	bɹʊɹftsefp
nulniɹk	nʊlnɪɹk
lɹinsɛs	lɹintɛs
siɹfsɹɔɹp	sɪɹfsɹɔɹb
zeɹbnɹiɹk	deɹbnɹiɹg
nudnɹɔk	nʊdnɹɔg
tsibpɸif	tsibpfif
ɣifpdɹæp	gifptɹap
ɹuɹbsɹæɹ	ɹuɹbsɹaɹ
bɹɛnssɹuɹk	pɹɛnssɹuɹk
seɹsnɹuɹt	teɹsnɹuɹt
lɹipdɹust	lɹiptɹʊst
ɢutnæɹk	gʊtnaɹg
ɸɔɹbnɹif	pɔɹbnɹif
bɹeɹdbɹi	bɹeɹdpɹi
sɹɛlɹut	sɹɛlɹud
nɛtquns	nɛtkʊns
seɹffɹæk	seɹffɹak
snestsil	snesttɪl
gɹɔɹzuk	gɹɔɹtug
quɹgzuk	kuɹgduk
nɹiglɹut	nɹɪglɹut
ɢuɹnlɹuk	gʊɹnlɹʊg
lɹɔɹlsɹuɹ	lɹɔɹlsɹuɹ
bɹinssnɛɹp	pɹɪnssnɛɹb
fupsis	fʊptis
qofpquk	kofpkʊg
bɹobsɹæt	bɹobsɹat
bɹusdɹiɹl	bɹʊstɹiɹl
gɹeɹbβœɹf	gɹeɹpbɛɹf
bɹufbɹep	pɹufbɹeb
sɹedbɹel	sɹedpɹel
tsɔstɢɔfp	tsɔstgɔfp
sɹæɹgnɹens	sɹaɹgnɹens
gɹɛɹfɹɛf	gɹɛɹfɹɛf
nɹitɸøɹn	nɹɪtpeɹn
siɹfɸuɹn	tɪɹfpuɹn
fibnɛn	fibnɛn
bɹufpqons	pɹufpkons
kæɹdgɹuɹp	kaɹtkɹʊɹb
ɹokɢok	ɹokgog
fɛfzifp	fɛfdɪfp
lɛsiɹ	lɛtɪɹ
sɹiɹbbɹup	sɹɪɹpbɹʊb
lɹestsneɹk	lɹestsneɹg
læfbɹe	lafbɹe
ɹæfppɸiɹs	ɹafppfɪɹs
ɹefpgɹiɹp	ɹefpkɹiɹp
lɹufpɸet	lɹʊfpfet
snɔfbɹoɹf	snɔfpɹoɹf
gɹæɹlgɹoɹt	gɹaɹlkɹoɹd
ɣisit	gɪsit
tsɔbbɹɛɹp	tsɔbpɹɛɹp
dɹuɹbgɹe	tɹuɹpgɹe
gɹuɹbdɹis	gɹʊɹbdɹɪs
lɔnsis	lɔnsɪs
læspɸɔt	laspfɔt
ɸœmpɸis	pɛnpfis
fɹɛpɢɔɹ	fɹɛpgɔɹ
nælɹik	nalɹig
nɹɛɹgdɹoɹp	nɹɛɹgdɹoɹb
tsoɹgzuɹp	tsoɹgdʊɹp
seɹbsɹɔt	teɹbsɹɔd
nɹɛɹgfɹæp	nɹɛɹgfɹap
fɹæŋgɹist	fɹangɹist
gɹɔɹdsɹɛp	gɹɔɹtsɹɛp
ɹefles	ɹefles
dɹiɹŋɢut	tɹiɹngud
bɹɛnnɹæp	bɹɛnnɹap
dɹofpɸuɹ	tɹofpfʊɹ
dɹuɹgsæɹt	dɹʊɹgsaɹd
dɹuɹfdɹɛk	tɹuɹftɹɛk
lɔtfun	lɔtfʊn
ɹulloɹl	ɹulloɹl
βunssuk	bunssug
ɹekgɹuɹn	ɹekgɹuɹn
ɹugβɶɹf	ɹugbaɹf
zinssnoɹs	dɪnssnoɹs
βɶtdɹɛɹt	battɹɛɹt
dɹiɹggɹip	dɹiɹkgɹip
βiɹsgɹoɹk	biɹskɹoɹk
pɸɛɹɹif	pfɛɹɹɪf
βɔɹfdɹut	bɔɹfdɹut
gɹuskæɹp	gɹuskaɹb
nɹɔɹlsoɹs	nɹɔɹltoɹs
ɸøɹfɹeɹ	peɹfɹeɹ
gɹiɹgɹuɹp	gɹɪɹkɹʊɹp
gɹuɹsβɔɹt	gɹuɹsbɔɹt
lɔɹddɹɔɹn	lɔɹdtɹɔɹn
pɸufdɹɛfp	pfuftɹɛfp
gɹɔɹbdɹɔk	gɹɔɹptɹɔg
eggɹok	eggɹog
suɹlsil	tuɹlsil
lɹædlɛfp	lɹadlɛfp
zɛsɸøt	dɛspet
tsuglɹi	tsuglɹi
xebfɹɔɹk	kebfɹɔɹk
tsɔɹloɹl	tsɔɹloɹl
gɹuɹlfil	kɹuɹlfɪl
βøɹŋxins	beɹnkɪns
gɹosbɹup	gɹospɹub
gɹiɹdɸɔst	gɹiɹtpɔst
nɹuksi	nɹʊktɪ
ɢusɸœ	gʊspɛ
sɹɛbfɹuf	sɹɛbfɹuf
nɹæɹfgɹiɹt	nɹaɹfgɹɪɹd
byɹlsɹɛf	bɪɹlsɹɛf
ɣɛgɹæk	gɛkɹag
ɹoɹdɹiɹt	ɹoɹtɹɪɹt
βɶlbɹofp	balpɹofp
pɸufsɹɔl	pfufsɹɔl
gækpɸeɹl	gakpfeɹl
gɹɛstsuk	gɹɛstsug
fɹoɹlniɹk	fɹoɹlniɹg
lænɹus	lanɹʊs
bɹɔɹbgɹiɹt	bɹɔɹbgɹiɹd
nɹuɹbsuɹp	nɹʊɹptuɹp
dɹosɛɹ	tɹotɛɹ
xɛfptsoɹ	kɛfptsoɹ
dɹiɹbɣiɹp	tɹiɹbgiɹp
fɹiɹgziɹt	fɹɪɹgdɪɹd
asfɹun	asfɹʊn
lɹuɹbɹɔɹp	lɹuɹbɹɔɹb
sɛfnifp	tɛfnɪfp
sotsɹiɹ	totsɹɪɹ
bɹæfneɹp	pɹafneɹp
ɛɹgzu	ɛɹgdʊ
bɹuflup	bɹʊflʊp
lolpɸæp	lolpfab
pɸɔbgɹɛt	pfɔbkɹɛt
sɹoslɔp	sɹoslɔb
pɸuslæst	pfʊslast
nɹɛgɹup	nɹɛkɹʊp
snuɹgfɹæɹn	snʊɹkfɹaɹn
xiknɹɔɹn	kiknɹɔɹn
dɹostdɹup	tɹostdɹub
bɹifpɸop	pɹifpfob
dænsnik	dansnɪg
sɹɔgtsuɹn	sɹɔgtsʊɹn
gɹæɹgtsust	gɹaɹgtsust
tsæɹbfoɹk	tsaɹbfoɹg
snɔdlek	snɔdleg
fɹonsdɹep	fɹonstɹep
ɸuɹslɹɔk	pʊɹslɹɔk
nɹiɹlsɛf	nɹiɹltɛf
sɔtdɹæɹp	sɔttɹaɹp
ɸidsɹɛs	pidsɹɛs
suɹftsup	tʊɹftsup
zoɹlɹist	doɹlɹist
eɹgβiɹt	eɹkbiɹd
xɛgɹiɹt	kɛkɹiɹd
bɹɔɹlgɹɔɹf	bɹɔɹlkɹɔɹf
bɹifnɹɔp	pɹɪfnɹɔp
gɹuβifp	kɹʊbifp
lænsust	lansust
gɹunssɹɔn	gɹunssɹɔn
sofgɹuɹ	sofgɹʊɹ
ziɹsbɹuɹt	dɪɹspɹʊɹd
ɸuɹgdɹeɹl	puɹktɹeɹl
ɸɶɹblɛɹp	paɹplɛɹb
tsiɸœt	tsɪpɛd
nɹeɹsluɹs	nɹeɹslʊɹs
fæfpdɹɛp	fafptɹɛp
dɹunsɸot	dɹʊnspot
ɣiszɛt	gɪsdɛt
ɹɔɹzuk	ɹɔɹtʊg
dɹulɣin	dɹʊlgɪn
βibɸøɹk	bibpeɹk
βɶdgɹun	badkɹun
bɹinoɹt	bɹɪnoɹd
lekdɹæp	lektɹab
nɹempyɹs	nɹenpɪɹs
uɹgnɹɔɹp	ʊɹgnɹɔɹb
lɹuɹfɢuɹt	lɹʊɹfgʊɹd
zoɹbniɹf	doɹpnɪɹf
ɹetβuɹp	ɹetbʊɹb
fɹuɹnnɹuɹl	fɹuɹnnɹʊɹl
zeɹdɹoɹn	deɹtɹoɹn
gɹognit	gɹognɪt
nuftæɹ	nʊftaɹ
fitgɹut	fitkɹʊt
fussɹif	fussɹif
ɸøtsɹol	petsɹol
nɹesxit	nɹeskid
nælsɹæst	nalsɹast
fɹɔfpbɹæɹ	fɹɔfpbɹaɹ
fɹipgɹins	fɹɪpgɹins
lɹuɹldɹɛl	lɹʊɹldɹɛl
tsittsust	tsittsust
ɸuɹɹɛɹ	pʊɹɹɛɹ
bɹuɹsɛɹk	bɹuɹsɛɹg
lɹoɹggɹuɹk	lɹoɹggɹuɹk
dɹigso	tɹigso
nopɸɛɹp	nopfɛɹb
qupgɹuɹt	kʊpkɹuɹd
gɹiɹŋxip	gɹiɹnkip
tsufɸins	tsufpins
ɹɔpɸæk	ɹɔpfag
tæfpɸɔɹk	tafppɔɹg
lɹofɸɶp	lɹofpap
dɹustluk	tɹʊstluk
fɹiɹgɹus	fɹiɹkɹʊs
ɣɛɹbdæt	gɛɹbdad
gɹufbɹæk	kɹufpɹag
byɹsfɔn	bɪɹsfɔn
sotsa	sotsa
βɔɹdzon	bɔɹtdon
lɹidɸiɹs	lɹidpiɹs
dɹɛɹbfɛl	tɹɛɹpfɛl
bɹiɹfen	bɹɪɹfen
dɹikdæs	dɹɪkdas
ɣiksnɛɹt	gɪksnɛɹt
fɛɹnsæfp	fɛɹnsafp
nuɹfziɹp	nuɹfdɪɹp
lɹuɹbɸɶɹl	lɹʊɹppaɹl
gɹodɸɔɹt	kɹodpɔɹt
dɹiɹlɹuf	dɹɪɹlɹʊf
dɹibdɹifp	dɹɪbtɹɪfp
bɹɔlsnɛs	pɹɔlsnɛs
fɹesiɹk	fɹetiɹg
ɸusɹuɹs	pusɹʊɹs
nɹɛɹeɹt	nɹɛɹeɹt
nɹidlæp	nɹɪdlab
bɹoɹɱfuɹf	pɹoɹnfuɹf
gɹiɹdgɹu	kɹiɹdkɹʊ
nɹibdɹup	nɹɪbdɹub
leɹgsɹofp	leɹgsɹofp
soɹdlɹæɹn	soɹtlɹaɹn
ɹædɸuɹp	ɹadpʊɹb
etsep	ettep
bɹuŋgæɹp	bɹʊngaɹp
nɹɛgɹoɹp	nɹɛkɹoɹp
ɸɶɹdsoɹf	paɹttoɹf
nɹinsdæt	nɹinsdat
ɢuɹfseɹt	gʊɹfseɹd
nɛɹslɹon	nɛɹslɹon
sniɹlsnuɹn	sniɹlsnuɹn
fonsqɔfp	fonskɔfp
sniɹŋxeɹp	sniɹnkeɹp
bɹɛɹbtsoɹt	pɹɛɹptsoɹt
gɹoffɹɛɹt	kɹoffɹɛɹd
siɹglɹuɹk	tiɹklɹʊɹk
lɹiɹsdɹop	lɹiɹstɹop
bɹæɹgnɹɔfp	bɹaɹgnɹɔfp
dɹildɹoɹf	tɹɪltɹoɹf
snefpgɹɛɹp	snefpkɹɛɹb
lupɣɛɹp	lupgɛɹb
pɸulæɹf	pfʊlaɹf
sɹiɹbsɹuk	sɹɪɹbsɹʊk
ɔtsɹiɹp	ɔtsɹɪɹp
pɸodɸup	pfodpʊb
dɹulɢust	tɹʊlgust
ɹiɹgɢoɹs	ɹiɹkgoɹs
ɸuɹffɹok	pʊɹffɹok
lɹɛmɸut	lɹɛnput
tsuɹgbɹop	tsʊɹgpɹob
snɔpsɹip	snɔpsɹɪb
dɹumbɹɛp	tɹʊnpɹɛb
bɹugɹok	pɹukɹok
pɸoɹffɹik	pfoɹffɹɪk
fuɹgfɹuɹp	fuɹkfɹuɹp
fɛtsɛɹt	fɛtsɛɹd
gɹɔɹfpɸɔk	kɹɔɹfpfɔg
liɹstsik	liɹstsɪg
xɛgnɔt	kɛgnɔd
gɹizɛ	gɹɪdɛ
qɔlgæn	kɔlgan
ɔɹnɹot	ɔɹnɹot
suɹfβøp	tuɹfbep
dɹæfpgɹɔns	tɹafpgɹɔns
sɹifpgɹuɹp	sɹifpkɹuɹb
bɹofnɔɹs	bɹofnɔɹs
sɹeɹdfɹis	sɹeɹdfɹɪs
lɹæɹnɹɔp	lɹaɹnɹɔp
xɛfpyɹk	kɛfpɪɹk
pɸonɹæɹ	pfonɹaɹ
gɹæɹbnɹen	kɹaɹpnɹen
nɹælsa	nɹalsa
ɸɶɹbfɹɔɹs	paɹpfɹɔɹs
gɹiɹsbɹæt	kɹiɹspɹad
sukseɹk	tʊkteɹk
βɔstzuɹt	bɔstduɹd
sɹoɹdbɹun	sɹoɹdpɹun
isɣɛɹs	isgɛɹs
gɹikqɔt	gɹikkɔt
tseɹŋɢot	tseɹngot
gɹɛɹdnɹiɹ	kɹɛɹtnɹɪɹ
ɸɔɹgsɛɹn	pɔɹgtɛɹn
zoldɹup	doltɹub
ɸødxiɹk	pedkiɹk
nɔfpnɹɔn	nɔfpnɹɔn
tsɛdɸoɹ	tsɛdpoɹ
tsæstdɹi	tsasttɹɪ
tsopɸiɹp	tsopfiɹp
ɸoɹfpɸeɹ	poɹfpfeɹ
bɹɛpquɹ	bɹɛpkʊɹ
ɹossnuns	ɹossnʊns
snæɹbdɹeɹl	snaɹpdɹeɹl
dɹinsβiɹt	dɹinsbiɹt
bɹiɹglæk	pɹiɹklak
bɹusnɹis	pɹʊsnɹɪs
sniɹgɸok	snɪɹkpok
lɹɛɹɣiɹl	lɹɛɹkɪɹl
tsɔstdæɹk	tsɔstdaɹk
lɹuɹgfɹɔns	lɹʊɹkfɹɔns
lɹɔgdɹop	lɹɔgdɹop
fɔɹbgɹop	fɔɹpgɹob
dɹifplɹiɹk	tɹɪfplɹɪɹk
lɹɛɹbnef	lɹɛɹbnef
læɹbgɹɛɹs	laɹbgɹɛɹs
tsɛɹsnɛk	tsɛɹsnɛg
gɹestdɹɛfp	gɹesttɹɛfp
ɹotsuk	ɹottug
lɛtgɹɔɹn	lɛtkɹɔɹn
fɹiksnɛk	fɹɪksnɛg
dɹæɹmpɸuɹt	tɹaɹnpfuɹd
dɹinlɹɛɹs	tɹɪnlɹɛɹs
gɹɛɹgnest	kɹɛɹgnest
uɹbdɹɔk	ʊɹbtɹɔk
niŋgɹuɹp	nɪngɹuɹp
lɹæstfeɹk	lɹastfeɹg
quɹsgɹen	kuɹsgɹen
niɹbfin	niɹpfin
ɹinsβok	ɹɪnsbok
qodxiɹt	kodkiɹt
subgɹun	sʊbgɹun
ɹepbɹɔp	ɹeppɹɔp
gɹubɸop	gɹʊbpop
nɹuɹbnɹif	nɹʊɹbnɹɪf
sifbɹup	tifbɹub
bɹɔfpɸø	bɹɔfppe
gɹɛfpbɹa	kɹɛfppɹa
sɹiɹfons	sɹɪɹfons
fɹɔɹndɹif	fɹɔɹntɹif
lensɣiɹt	lensgɪɹd
ɸɔstneɹl	pɔstneɹl
gɹæɹskæɹp	kɹaɹskaɹp
dɹipβoɹt	dɹɪpboɹt
ɢuqɔɹl	gʊkɔɹl
unɛɹt	unɛɹd
snæɹsfɹop	snaɹsfɹop
ɸœfpsɔɹl	pɛfpsɔɹl
bɹuɹbɹef	pɹʊɹbɹef
dɹuɹgbɹɔfp	tɹuɹgbɹɔfp
sufdɹufp	tʊftɹʊfp
fosxit	foskɪd
lɹesdɹoɹ	lɹestɹoɹ
sondɹeɹk	tontɹeɹk
dɹuɹæn	tɹʊɹan
ɸønstæf	penstaf
pɸibsɹifp	pfibsɹɪfp
pɸiɹdɢɔɹs	pfɪɹdgɔɹs
dɹegfɹæt	dɹegfɹad
ɹefplɹep	ɹefplɹeb
nɹifquk	nɹifkʊk
sobdɹɔɹp	tobdɹɔɹb
dænun	danʊn
dɹibdɹuk	tɹibdɹuk
ɸuɹnlɹuɹn	puɹnlɹuɹn
dɹiɹgpɸon	dɹiɹgpfon
sɹoɹɣɛk	sɹoɹkɛk
lɹeɹntsæɹ	lɹeɹntsaɹ
fɹutzoɹt	fɹutdoɹd
oɹdɢuɹk	oɹdguɹg
bɹɛɹbɸiɹt	bɹɛɹppiɹd
sɹupgɹæn	sɹupgɹan
fegqɔɹt	fegkɔɹt
gɹultsɛfp	gɹultsɛfp
lɹiɹlɢup	lɹiɹlgʊb
tsesɹɔɹ	tsesɹɔɹ
ɹoɹndɹæɹp	ɹoɹndɹaɹb
dɹwɔɹt	dɹʊɔɹt
ɹoɹbsɛɹk	ɹoɹbtɛɹk
fiɹbbɹoɹs	fiɹpbɹoɹs
fɹuɹlbɹuɹk	fɹʊɹlbɹʊɹg
bɹonsfoɹn	pɹonsfoɹn
bɹuɹdɢuk	pɹuɹdgʊk
sneɹbbɹæp	sneɹbbɹap
lɹugbɹup	lɹugpɹʊb
ɸɔfbɹip	pɔfpɹib
tsæɹnnɔl	tsaɹnnɔl
ɣiɹdnɹɔp	gɪɹtnɹɔb
zoɹfɸus	doɹfpus
zunsniɹt	dunsniɹd
bɹiɹgæs	bɹɪɹkas
pɸɔfpɸeɹp	pfɔfpfeɹb
dæstpɸɛ	dastpfɛ
tæsbyt	tasbɪt
gɹombɹoɹl	kɹonpɹoɹl
sɔɹgnɹiɹf	tɔɹgnɹɪɹf
zestsɹɔɹf	destsɹɔɹf
gɹɔɹdβœɹn	gɹɔɹtbɛɹn
susɸuɹt	suspʊɹd
gɹodbyfp	kɹodbɪfp
sɹoɹβɔk	sɹoɹpɔg
bɹɔfɹɛn	pɹɔfɹɛn
dɹeɹlin	tɹeɹlin
lɹɔgdɹol	lɹɔgtɹol
pɸændɹis	pfandɹis
bykɣik	bɪkgɪg
nikbɹeɹp	nikpɹeɹb
futsu	futsʊ
ɸɶɹgkæfp	paɹkkafp
ɔɹdfun	ɔɹdfun
kælsnes	kalsnes
lɹɔgsist	lɹɔgtist
tsiɹdfɹik	tsɪɹtfɹik
nægɸiɹl	nagpiɹl
bɹiɹbsnufp	bɹɪɹpsnufp
dɹullɹik	tɹʊllɹig
nefpdɹup	nefptɹʊb
tsuɹgsɹiɹl	tsʊɹksɹɪɹl
xisbɹis	kɪsbɹis
suɹbdɹol	sʊɹpdɹol
bɹoɹbpɸuɹl	pɹoɹppfʊɹl
lɔɹdlifp	lɔɹdlɪfp
ɸɶɹffɹip	paɹffɹip
ɹeɹnsɹɛɹt	ɹeɹnsɹɛɹt
sɹiliɹk	sɹilɪɹk
pɸɛdtsɔf	pfɛdtsɔf
ugleɹf	ugleɹf
fɛɹbgɹæst	fɛɹpkɹast
gɹælloɹf	gɹalloɹf
pɸɔgsɹuns	pfɔgsɹuns
ɹinsɹif	ɹɪnsɹif
oɹdgɹæl	oɹdgɹal
snuɹsnuɹp	snʊɹsnʊɹb
zoɹdgɹut	doɹtgɹud
ɸœɹgquf	pɛɹgkʊf
bɹulɸɔɹl	bɹulpɔɹl
dæɹsgɹiɹk	daɹsgɹɪɹg
fɛnniɹk	fɛnniɹg
bɹiɹmpɸiɹp	bɹɪɹnpfiɹp
βugdɹiɹt	bugdɹiɹd
nɹusβut	nɹusbʊt
nɹifsɔɹt	nɹɪfsɔɹd
dɹuɹgɢɔl	dɹʊɹggɔl
gægɹoɹl	gakɹoɹl
niɹfsɹiɹ	nɪɹfsɹiɹ
fɹiɹbsuɹt	fɹɪɹpsʊɹd
nɹɛɹfsɹɛn	nɹɛɹfsɹɛn
nɹiɹssɔɹk	nɹɪɹstɔɹk
zedxiɹf	dedkɪɹf
nistsuf	nistsuf
xepnɔl	kepnɔl
tsiɹdsek	tsɪɹdsek
lɹistɸuɹt	lɹɪstpʊɹd
bɹunslɹeɹp	pɹunslɹeɹb
xiɹbɸuɹf	kɪɹppʊɹf
qɔggɹɛɹl	kɔgkɹɛɹl
suptsuɹ	tuptsʊɹ
luɹdfiɹf	luɹtfiɹf
fodsuɹf	fodsʊɹf
bɹɔdfɹɔɹt	pɹɔdfɹɔɹt
lɹuɹssɹæp	lɹʊɹssɹap
nistfɹɔɹp	nistfɹɔɹb
zegtsuɹl	degtsʊɹl
sɛsdɹuɹt	tɛstɹʊɹt
lɛɹgnɛɹn	lɛɹgnɛɹn
fɹæstdɹef	fɹastdɹef
qolnɹuɹf	kolnɹʊɹf
xiɹblæɹk	kiɹplaɹk
ɣɛksɹiɹl	gɛksɹiɹl
gɹulsiɹt	kɹʊlsɪɹd
otbɹuɹt	otpɹʊɹt
sɹɔfxiɹp	sɹɔfkiɹp
fɔɹdɹip	fɔɹdɹip
siɹffɹist	sɪɹffɹɪst
gɹeɹɢut	gɹeɹkʊd
gɹistsnon	gɹistsnon
lelsnif	lelsnif
snogkæɹn	snogkaɹn
βutsɹæt	bʊtsɹad
qɔklɹæɹk	kɔklɹaɹk
tsiɹzɛp	tsɪɹdɛp
nusɹuɹl	nʊsɹʊɹl
fɹustbɹɔn	fɹustbɹɔn
tæbdɹuɹp	tabdɹʊɹb
nɹæɹsgɹu	nɹaɹskɹʊ
siɹdsil	siɹttɪl
sɹizip	sɹɪdip
zɛbbɹɛn	dɛbbɹɛn
sniɹgkæn	sniɹgkan
niɹfgɹiɹp	nɪɹfgɹiɹp
qobdɹɔl	kobtɹɔl
dɹeɹlpɸek	tɹeɹlpfeg
bɹilxit	pɹɪlkɪd
ɹubɹifp	ɹupɹifp
βœfpnɹɔɹs	bɛfpnɹɔɹs
βiɹgpɸæfp	biɹgpfafp
fɹɔllɹɛn	fɹɔllɹɛn
pɸɔksnɔk	pfɔksnɔk
siɹdsæf	siɹdsaf
loɹbgɹuɹt	loɹbgɹuɹt
gɹuɹfut	kɹʊɹfʊt
lɹotbɹoɹk	lɹotbɹoɹk
gɹugluɹ	kɹʊglʊɹ
zɔmbɹuɹ	dɔnpɹʊɹ
gɹiɹdlu	kɹɪɹdlu
bɹɔpɸuns	pɹɔppʊns
dɹiblɹeɹt	tɹiblɹeɹt
xidbɹuɹk	kidpɹʊɹg
fɹupsek	fɹʊptek
gɹistsun	gɹistsʊn
tsokfest	tsokfest
ɹiɹŋgɹɔp	ɹiɹngɹɔp
pɸeɹbβœɹp	pfeɹpbɛɹb
lɹiblɹofp	lɹiblɹofp
bɹisɔp	bɹisɔb
snɛfpbɹist	snɛfppɹist
pɸuɹgnɹæl	pfuɹknɹal
gɹipbɹit	gɹɪpbɹid
sɹodpɸu	sɹodpfʊ
ɹisnæɹt	ɹisnaɹt
xɛfpsol	kɛfpsol
dɹiɹdlif	tɹiɹtlif
tsiɹssuk	tsɪɹstuk
sufɸins	tufpins
niɹɣɛfp	nɪɹgɛfp
qɔfpbɹuɹ	kɔfpbɹuɹ
ɹonsnɹep	ɹonsnɹep
qɔlsu	kɔltʊ
leɹgzɔl	leɹkdɔl
bɹɔkbɹuɹk	bɹɔkbɹuɹg
ɹifbɹɛɹt	ɹɪfpɹɛɹd
snoɹgtsuk	snoɹktsʊg
ɹuɹblis	ɹuɹblɪs
fɹusɸɶfp	fɹuspafp
tsuɹbtsun	tsuɹptsʊn
siɱfɹɔɹt	sɪnfɹɔɹt
xiɹgsnit	kɪɹgsnit
bɹeblɛɹp	pɹeblɛɹb
gɹiɹgsnens	gɹɪɹgsnens
lɹæɹlfɹiɹn	lɹaɹlfɹiɹn
suttseɹp	suttseɹb
sunsoɹp	sʊntoɹb
βuɹβuɹs	buɹpuɹs
dɹɔgniɹt	tɹɔgniɹt
itsnæɹf	ɪtsnaɹf
ɹeɹdbɹufp	ɹeɹdbɹʊfp
ɛpsnɔn	ɛpsnɔn
βuɹdβiɹl	buɹtbiɹl
gɹeɹgsɹæɹp	kɹeɹksɹaɹp
ɹustdɹeɹ	ɹustdɹeɹ
gɹɛɹsβip	gɹɛɹsbip
sɹuɸøp	sɹʊpep
lɹotnɹu	lɹotnɹʊ
nɹæssin	nɹastɪn
ifbɹɔl	ifpɹɔl
xistsuɹ	kisttʊɹ
pɸɔgfɹɔn	pfɔgfɹɔn
ɹæfppɸɔt	ɹafppfɔd
gɹædsnok	kɹadsnog
ɔɹloɹp	ɔɹloɹb
sɛnsquɹn	sɛnskuɹn
nɹæɹnsek	nɹaɹnteg
ɹoɹlsoɹt	ɹoɹltoɹd
dæɹbɹik	daɹbɹig
ifpsɔɹ	ɪfpsɔɹ
dɹeβɶɹk	dɹebaɹg
bɹɔstnɹɔns	pɹɔstnɹɔns
dɹutleɹp	tɹʊtleɹb
βɶgbɹop	bagpɹob
gænsɸuɹk	ganspʊɹk
bɹiblins	pɹɪblɪns
ɹeɹfɹæɹn	ɹeɹfɹaɹn
βipxiɹk	bipkiɹk
gɹɛtbɹæt	gɹɛtbɹad
βonszuɹp	bonsduɹb
dɹæɹfβoɹt	tɹaɹfboɹt
tsustsit	tsʊstsit
zinsfeɹn	dinsfeɹn
pybniɹt	pɪbniɹd
fɹiɹnsɹun	fɹiɹnsɹun
sinsnik	sɪnsnɪg
fɹisdɹons	fɹistɹons
lɹuɹsdɹiɹl	lɹʊɹstɹiɹl
findɹeɹl	fɪndɹeɹl
sustsnut	tʊstsnʊt
sɹɔɹbɹeɹt	sɹɔɹpɹeɹt
siɹbqɔn	siɹbkɔn
dɹustgɹɛɹk	tɹʊstgɹɛɹk
fɹuɹdɣeɹt	fɹʊɹdgeɹd
gɹilbyt	gɹilbɪd
nɹoɹddɹɛɹs	nɹoɹtdɹɛɹs
fiɹftsiɹk	fiɹftsiɹg
ɸøɹfnuk	peɹfnuk
dɹɛɹzen	dɹɛɹten
pɸesdɹuɹl	pfestɹuɹl
sɹuɹndɹin	sɹuɹntɹɪn
ɹuffɹɔp	ɹuffɹɔp
ɹusdɹɛn	ɹʊsdɹɛn
qofpɸiɹp	kofpfiɹb
iɹlɹɔp	ɪɹlɹɔb
zonlit	donlɪt
sɹɛstβɶst	sɹɛstbast
bykɸoɹt	bɪkpoɹt
oflɛɹf	oflɛɹf
ɸøɹdsest	peɹtsest
bɹeɹfsɛst	bɹeɹftɛst
lɛfβu	lɛfbu
bɹunɔf	pɹʊnɔf
lɹubdɹæfp	lɹubtɹafp
nɹɔfdɹup	nɹɔfdɹub
siɹsgɹik	sɪɹskɹɪg
ɢuldɹɛɹt	guldɹɛɹd
nɹuɹflɹel	nɹʊɹflɹel
pɸɔfɹuk	pfɔfɹuk
ɹɛɹgfɛɹp	ɹɛɹkfɛɹb
netsip	nettip
quflep	kuflep
sɔnssɹist	sɔnssɹɪst
zeɹdlɹis	deɹdlɹɪs
dɹæpɢust	tɹapgʊst
βønssip	benssib
fɹæɹfsɹɔ	fɹaɹfsɹɔ
dɹɔfɔɹf	tɹɔfɔɹf
lɹoɹbtsɛɹp	lɹoɹptsɛɹp
nɹɔɹbɢɔɹp	nɹɔɹbgɔɹp
lultsup	lultsʊp
kæstgɹet	kastkɹed
xegɢufp	keggʊfp
dɹuɹlgɹet	dɹʊɹlgɹed
zukquf	dukkʊf
leslefp	leslefp
lɹoɹbbɹɔɹf	lɹoɹbpɹɔɹf
ɸɔfgɹɛt	pɔfgɹɛt
pɸæɹssɔɹk	pfaɹstɔɹk
dɹofpβɔɹk	tɹofpbɔɹg
pysgɹus	pɪsgɹʊs
xiɹbɸøt	kiɹpped
ɸɶŋgɹuɹt	pankɹuɹd
bɹufpdɹut	pɹʊfpdɹud
bɹitzɛɹl	bɹɪtdɛɹl
dɹæstlop	dɹastlop
lɹæpdɹef	lɹapdɹef
tsuɹlɢufp	tsʊɹlgʊfp
gɹæɹblɛns	gɹaɹplɛns
fɔɹbsɹek	fɔɹbsɹeg
xɛɹbɣeɹl	kɛɹpgeɹl
ufpɸuɹk	ufpfuɹg
nɹɛstlɹiɹk	nɹɛstlɹiɹk
bɹiɹdtsɔɹk	pɹiɹdtsɔɹk
fælsnɔn	falsnɔn
sutsæf	tʊtsaf
ɹiɹslɹɛp	ɹɪɹslɹɛp
fɹiɹsgɹiɹk	fɹɪɹsgɹiɹg
ɣeɹblɹit	geɹblɹɪd
lɹoɹlbɹif	lɹoɹlbɹif
βɶɹsnoɹn	baɹsnoɹn
tsinnɹɔk	tsinnɹɔk
sɹiɹdlɹuɹs	sɹɪɹdlɹʊɹs
aɹnɹɔɹl	aɹnɹɔɹl
bɹunsbɹuɹt	bɹʊnspɹuɹd
βœɹdsnik	bɛɹdsnɪg
xɛɹgpɸup	kɛɹkpfup
pɸuɹnsɛt	pfuɹntɛd
fɔpdɹot	fɔptɹot
tæɹggɹɛɹf	taɹkkɹɛɹf
gɹɔfβoɹk	kɹɔfboɹg
sepgɹɛɹ	tepkɹɛɹ
ɹɛkɸuɹf	ɹɛkpuɹf
ilɹuɹf	ɪlɹuɹf
βogβøɹ	bogbeɹ
sɛɹblɹut	tɛɹblɹʊt
bɹoɹbdɹuɹp	bɹoɹpdɹʊɹb
sɹæɹnnuns	sɹaɹnnʊns
dædsɹeɹ	dadsɹeɹ
pɸusɹæɹp	pfʊsɹaɹp
ɢoɹlsɹuɹf	goɹlsɹuɹf
sɹuɹmbɹuɹk	sɹʊɹnbɹʊɹg
nussɹɛp	nussɹɛb
gɹiɹbgɹɛf	gɹɪɹpkɹɛf
ɹoɹɱfel	ɹoɹnfel
xigniɹt	kɪgniɹt
sɹoɹdlɹiɹt	sɹoɹdlɹɪɹt
dɹostbɹɔt	dɹostpɹɔd
dɹiɹnɛt	dɹɪɹnɛd
fæbgɹul	fabgɹʊl
pɸɛɹɣin	pfɛɹkin
dɹelnæl	tɹelnal
sundɹæk	tʊntɹag
lɹuɹsnɹeɹn	lɹuɹsnɹeɹn
ɹeɹlfɹɛk	ɹeɹlfɹɛk
fuɹsfet	fuɹsfet
xeŋquɹk	kenkuɹk
zonsɹoɹp	donsɹoɹp
ɹofβit	ɹofbit
ɣiɹzit	giɹdid
fɹeddɹæt	fɹeddɹat
dɹɛɹdɹɛɹk	tɹɛɹdɹɛɹk
snɛkdɹins	snɛkdɹɪns
gɹiɹfnɹep	gɹiɹfnɹep
gɹifpbɹɔt	kɹifpbɹɔt
liɹbgɹip	lɪɹbgɹib
ɣiɹnoɹl	giɹnoɹl
suɹɣiɹp	sʊɹkɪɹb
tsunspɸut	tsʊnspfʊt
fɹiɹgzuɹf	fɹiɹgduɹf
ɸœxɛ	pɛkɛ
bɹuɹbsɔst	pɹʊɹptɔst
dɹuɹntsuk	dɹʊɹntsug
sɹæfplɹæɹf	sɹafplɹaɹf
loɹfpɸæɹk	loɹfpfaɹg
dɹɛɹbqɔɹp	tɹɛɹbkɔɹp
eɹmɸuɹf	eɹnpʊɹf
gɹɛɹbgɹeɹk	gɹɛɹpkɹeɹk
pɸekfiɹk	pfekfɪɹk
pɸuɹɹel	pfʊɹɹel
lɹɛseɹl	lɹɛseɹl
gɹuŋgɹin	kɹunkɹɪn
bɹæfbɹoɹl	bɹafpɹoɹl
ɹɛɹɹuɹk	ɹɛɹɹʊɹg
soɹbɣik	soɹpgig
ɸuɹgɹuɹp	pʊɹkɹuɹb
nubsnon	nʊbsnon
dɹeɹop	tɹeɹop
nɛɹssut	nɛɹstud
ɸuɹlfɹeɹk	pʊɹlfɹeɹk
pɸufnɹæf	pfʊfnɹaf
linsul	lɪnsʊl
fuɹdgæɹ	fuɹtgaɹ
tseɹfpɸe	tseɹfpfe
sipgɹɛk	sɪpgɹɛk
gɹæɹgsɹæɹl	kɹaɹgsɹaɹl
ɢuɹspɸɛl	guɹspfɛl
tsebqost	tsebkost
snifpβɔp	snifpbɔb
dɹɔtgɹuk	dɹɔtgɹug
bɹæɹgsɔɹp	pɹaɹksɔɹb
nɹiɹdloɹp	nɹɪɹdloɹp
dɹuɹsgɹɛɹs	dɹʊɹskɹɛɹs
ɣeɹfsnæɹk	geɹfsnaɹg
tsuɹɱfɹuɹp	tsʊɹnfɹʊɹb
sɹɔɹɹos	sɹɔɹɹos
gɹonssen	kɹonssen
zɔnspɸɛns	dɔnspfɛns
ɢustlɹut	gustlɹʊt
bɹoɹlseɹl	bɹoɹlseɹl
suɹfɣɛɹk	tuɹfgɛɹg
gɹolun	kɹolun
ɢɔɹfɸɔn	gɔɹfpɔn
gæɹldɹɔns	gaɹldɹɔns
ɸøfpgɹeɹf	pefpkɹeɹf
seɹdnoɹt	seɹtnoɹd
gɹɛtbɹuf	kɹɛtbɹuf
pɸeɹgsnup	pfeɹgsnup
ɢɔbsuk	gɔbtʊk
dɹoɹfuɹp	dɹoɹfuɹb
zɛɹfsins	dɛɹftins
lillɹiɹs	lɪllɹɪɹs
βufsnæns	bufsnans
nifptseɹf	nifptseɹf
nɔfnuɹp	nɔfnuɹb
næɹbtset	naɹbtset
fɹiɹgbɹit	fɹɪɹkbɹid
sifptsust	sifptsust
gɹiktsiɹk	gɹiktsiɹk
qoɹbɸoɹl	koɹppoɹl
tsiɹbɸuɹk	tsiɹppuɹg
βitsɛt	bittɛt
fɹoɹɹet	fɹoɹɹet
ɣɛɹgsnɛɹ	gɛɹgsnɛɹ
snɛsiɹf	snɛsɪɹf
dɹistbɹeɹf	tɹɪstpɹeɹf
dɹulsnup	dɹʊlsnub
ɸosttsit	posttsit
nɹɛtɸɶp	nɹɛtpap
pɸustbɹuɹ	pfustpɹuɹ
lidgɹɛp	lidkɹɛb
gɹudby	gɹudbɪ
sɹissit	sɹɪstit
lɹosɹiɹ	lɹosɹiɹ
dɹiɹbpɸins	dɹiɹppfins
ɢoɹfsok	goɹftog
snæfbɹɛɹp	snafpɹɛɹp
βoɹdɹif	boɹtɹɪf
fɹuɹflɹoɹn	fɹuɹflɹoɹn
xilzik	kɪldɪk
nubsnuf	nubsnʊf
lɹuɹfsnoɹt	lɹʊɹfsnoɹd
dɹopzok	tɹopdog
dɹɔdsuɹl	dɹɔdsuɹl
nɹɔbbyɹn	nɹɔbbɪɹn
lɹoɹsdɹɔst	lɹoɹstɹɔst
gɹufsɛɹ	gɹʊfsɛɹ
βuɹnlɛs	bʊɹnlɛs
dæstdɹeɹp	dastdɹeɹb
uɹfuns	uɹfʊns
loɹbsus	loɹbsus
tætsun	tattun
dɹibdɹeɹk	dɹibtɹeɹg
nɹægsɹuɹf	nɹagsɹʊɹf
sɹigβø	sɹigbe
nɛɹfsɹot	nɛɹfsɹod
bɹɛpsniɹp	pɹɛpsnɪɹb
sikfɹuɹ	tikfɹʊɹ
gɹiɱfɛɹk	kɹinfɛɹg
sustzɛns	tustdɛns
ɛbɹiɹl	ɛbɹiɹl
sɔɹβɔst	sɔɹbɔst
kæɹfnel	kaɹfnel
ɸɶtdɹofp	patdɹofp
agɹeɹn	agɹeɹn
dɹækbɹot	dɹakpɹod
suɹfdɹons	suɹfdɹons
sonsdɹæst	tonstɹast
apbɹist	appɹɪst
bɹuɹsɛl	bɹuɹsɛl
ɸɔɣifp	pɔgifp
dɹipɸɹek	dɹɪpfɹeg
bɹoɹfɸuk	pɹoɹfpʊg
gɹubpɸuɹp	gɹʊbpfʊɹb
eɹbzɔt	eɹbdɔd
iɹdɸɔɹt	iɹdpɔɹt
tæɹlpɸæɹf	taɹlpfaɹf
qotsɛt	kotsɛd
sulgɹuf	sulkɹʊf
bɹeɹdsuɹp	bɹeɹtsuɹp
lɹoɹssnok	lɹoɹssnog
læɹŋɣɛk	laɹngɛg
kæɹsnet	kaɹsnet
siɹdzes	sɪɹddes
fɹodsɹop	fɹodsɹob
bɹuɹdgɹuɹf	bɹuɹdgɹuɹf
lɹobfɹufp	lɹobfɹʊfp
dɹɔɹfxin	tɹɔɹfkin
ɸulxɛns	pulkɛns
tsuɹbnɹop	tsʊɹpnɹop
byɹnluɹp	bɪɹnlʊɹp
gɹifɹiɹt	kɹifɹɪɹt
ɹɔɹlɹun	ɹɔɹlɹʊn
dɹuɹsnɔ	tɹuɹsnɔ
pɸoɹsnɔl	pfoɹsnɔl
pɸusfiɹ	pfusfɪɹ
zefɹuɹk	defɹʊɹk
βofsnel	bofsnel
sɹifquns	sɹifkʊns
snonlæf	snonlaf
zoβuɹ	dobuɹ
aɹdfɹuɹt	aɹtfɹʊɹt
ɣɛstgɹeɹp	gɛstgɹeɹb
ebbɹe	ebbɹe
sɛpsiɹs	tɛpsɪɹs
snɛpnɹæl	snɛpnɹal
lɹegtsɛɹk	lɹegtsɛɹk
sikbɹuɹ	sɪkbɹuɹ
gɹoɹbɸøt	gɹoɹbped
nukgɹip	nʊkgɹɪp
dɹuɹbsɛɹs	dɹuɹbsɛɹs
fɹoɹgbɹiɹt	fɹoɹgpɹiɹd
ɸuɹgfu	pʊɹkfʊ
ɹuɹggɹæs	ɹʊɹkgɹas
sɹiɹfɹæk	sɹɪɹfɹag
ɸonsgɹo	ponsgɹo
fɹɛfdɹok	fɹɛfdɹog
dɹɔnslɹuɹk	dɹɔnslɹuɹk
zɛɹgɸøp	dɛɹgpep
sɹefɹul	sɹefɹʊl
sɹimɸu	sɹɪnpʊ
pɸestsɔst	pfestsɔst
bɹoklik	bɹoklɪk
fɹɛfptsun	fɹɛfptsʊn
zɛɹlɹɛst	dɛɹlɹɛst
zunæfp	dunafp
dɹæɹgnɛ	tɹaɹgnɛ
dæfpnuɹs	dafpnʊɹs
xidɹup	kitɹup
sɛsæt	sɛsat
dɹɔɹglɛɹp	tɹɔɹklɛɹb
βubpɸik	bubpfig
lætfɹɛs	latfɹɛs
ɢɔgɸoɹ	gɔgpoɹ
dɹiɹddɹifp	tɹiɹttɹɪfp
dɹoɹgbɹɔt	tɹoɹkbɹɔt
fulnɛk	fulnɛk
ɸɶdsɹiɹl	padsɹiɹl
tsenseɹn	tsenteɹn
bɹiɹfsnot	pɹiɹfsnot
dɹifpsef	tɹɪfptef
pɸiɹbluɹf	pfiɹblʊɹf
unstsoɹ	ʊnstsoɹ
nɹukdæfp	nɹʊkdafp
nɹeɹbkæf	nɹeɹbkaf
gɹiɹgtsiɹk	kɹɪɹgtsɪɹk
ɹeɹɣit	ɹeɹkɪd
zutpɸɔns	dʊtpfɔns
nɹiɹslɛɹt	nɹiɹslɛɹt
pɸuɹsgɹæɹs	pfuɹskɹaɹs
qobgɹiɹt	kobkɹɪɹt
nɹeɹdlæɹk	nɹeɹdlaɹk
nɹofpqɔf	nɹofpkɔf
dɹuplɹæfp	dɹʊplɹafp
nɹutnɹins	nɹʊtnɹins
fɹobdɹik	fɹobtɹɪk
sɹodsɹuɹt	sɹodsɹuɹt
sɹuɹɢɔɹf	sɹuɹkɔɹf
nɹennup	nɹennʊb
fɔɹbdɹæst	fɔɹpdɹast
tæɹgbɹiɹl	taɹkbɹiɹl
nɹubdɹeɹ	nɹʊbtɹeɹ
ɢoppyns	goppɪns
sɛɹdɣiɹk	tɛɹdgiɹk
bɹiptsus	bɹiptsʊs
itfik	ɪtfɪg
pɸæɹdzeɹl	pfaɹtdeɹl
sɹukziɹk	sɹukdiɹk
gɹiɹgqok	gɹiɹgkok
fɹæɹdsnun	fɹaɹtsnʊn
bɹoɹloɹl	bɹoɹloɹl
sutgɹuns	tʊtgɹʊns
dɹɔquk	tɹɔkʊk
tsɛɹgdɹis	tsɛɹgdɹɪs
sɹɔnsdɹofp	sɹɔnsdɹofp
dɹɛfdɹof	tɹɛfdɹof
bɹæɹfsnoɹ	pɹaɹfsnoɹ
siɹbno	tɪɹpno
snɛnsɹust	snɛnsɹʊst
lɹoɹbnɹop	lɹoɹbnɹop
bɹiɹbbɹufp	pɹɪɹbpɹufp
tsiɹnlɹɔk	tsiɹnlɹɔg
fuɹssɹeɹl	fʊɹssɹeɹl
nɛɹgneɹp	nɛɹgneɹp
pɸinnip	pfɪnnib
dɹeɹlbyns	tɹeɹlbɪns
sɛfpzik	sɛfpdɪg
bɹoɹblɹuɹk	pɹoɹplɹuɹg
pɸoɹdnɹens	pfoɹdnɹens
sniplɹuɹf	snɪplɹuɹf
lɔɹgbɹuɹt	lɔɹgpɹʊɹt
gɹefpbɹik	gɹefpbɹik
fɹufzup	fɹʊfdup
bɹoɹglɹɛɹk	pɹoɹglɹɛɹk
fuɹlbɹɔp	fʊɹlpɹɔb
tsæɹbɸup	tsaɹppʊp
ɹitseɹf	ɹitseɹf
βiɹglɹɔɹf	biɹglɹɔɹf
snɛnnɹæɹk	snɛnnɹaɹk
tsæɹszu	tsaɹsdu
pɸonsæɹt	pfonsaɹt
nɛdpɸɔɹn	nɛdpfɔɹn
lɹunstsɛɹt	lɹʊnstsɛɹd
pɸeɹlfep	pfeɹlfeb
sɹæbliɹs	sɹabliɹs
ɢudlop	gudlob
gɹæɹdzop	kɹaɹtdop
tsustɸœɹn	tsʊstpɛɹn
foɹfɹɛɹt	foɹfɹɛɹt
lɛdsnis	lɛdsnis
tsuɹbgɹæt	tsuɹpkɹad
qunsdɹuɹk	kunsdɹʊɹk
dɹifpsɔɹn	tɹifptɔɹn
ɹiɹlnut	ɹɪɹlnud
βøtdɹis	betdɹɪs
lipbɹæɹp	lipbɹaɹb
fɔɹgsin	fɔɹgtɪn
gɹuɹsbɹeɹt	kɹuɹsbɹeɹd
tsestgɹɔk	tsestkɹɔk
sosβuɹf	sosbʊɹf
dɹuɹmpyst	tɹʊɹnpɪst
fɹulsins	fɹʊltɪns
dɹæɹŋɢok	tɹaɹngog
qosɣeɹt	kosgeɹt
fɹɔkβɶɹp	fɹɔkbaɹp
pɸugsɔn	pfʊgsɔn
xilnes	kilnes
βɔɹbgɹæɹt	bɔɹpgɹaɹd
lɹuɹŋɢufp	lɹuɹngufp
gɹiɹbfɛ	kɹɪɹbfɛ
sɹeɹdbɹif	sɹeɹtbɹif
sæsnoɹs	sasnoɹs
luflɹiɹs	lʊflɹɪɹs
pyfgɹæp	pɪfgɹab
gɹuɹfɹɔɹn	kɹʊɹfɹɔɹn
ligɹin	lɪgɹin
βofnɹoɹk	bofnɹoɹg
xɛɹgβœk	kɛɹgbɛg
sɹepβøs	sɹepbes
lɹoɹnɹoɹp	lɹoɹnɹoɹp
ɹɔksuf	ɹɔksuf
dɹeɹdgɹut	tɹeɹtkɹud
snoɹmβɔɹp	snoɹnbɔɹp
feɹdlɹæfp	feɹtlɹafp
ɹuɹbnoɹk	ɹʊɹbnoɹk
ɸœɹdɹuf	pɛɹdɹʊf
feap	feap
dɹiɢus	dɹɪgus
xeɹftsiɹf	keɹftsiɹf
fɹɛɹsɔk	fɹɛɹsɔk
dɹɛɹbfɹiɹk	tɹɛɹpfɹɪɹk
gɹeɹfgɹæf	gɹeɹfkɹaf
sɛgɹæɹf	tɛkɹaɹf
dɹɔstxit	dɹɔstkɪt
dɹɔfnɛt	tɹɔfnɛt
idnut	idnʊt
sɹoɹgdɹuk	sɹoɹgtɹuk
zipsɹoɹt	dipsɹoɹt
bɹembɹæf	bɹenbɹaf
gɹeɹdnɹot	gɹeɹdnɹod
zɔlsnæɹp	dɔlsnaɹp
nɹoɹsfɹuɹk	nɹoɹsfɹʊɹk
ɸøɹlɢuns	peɹlguns
xɛɹnsɹot	kɛɹnsɹot
dɹætnɹiɹp	tɹatnɹiɹp
fɹisbɹæk	fɹɪspɹag
bɹudfok	pɹʊdfog
gɹefɸoɹn	kɹefpoɹn
lɹæɹnsɹit	lɹaɹnsɹid
foɹfuɹf	foɹfuɹf
nɹipsɹiɹk	nɹipsɹiɹg
idæɹp	ɪdaɹp
zibsɹɔɹt	dibsɹɔɹd
gɹɔɹlɹɛk	kɹɔɹlɹɛk
pɸuɹdβuk	pfuɹtbʊk
zeɹgnuf	deɹgnuf
lɹubnɹoɹp	lɹubnɹoɹp
ɣiɹlsnɔ	giɹlsnɔ
lifsnoɹk	lifsnoɹk
sidsnip	sidsnɪp
pɸuɹgdɹɛst	pfuɹktɹɛst
ɣidɸɶt	gɪdpad
gɹuɹmpɸæt	gɹuɹnpfad
zisbɹæɹp	dɪsbɹaɹb
zubtsip	dʊbtsɪp
sensfɹil	sensfɹɪl
bɹedloɹn	pɹedloɹn
ɸɔslil	pɔslɪl
ɸɔpsɹup	pɔpsɹup
lɹiɹɹoɹp	lɹɪɹɹoɹb
tseɹgpɸik	tseɹkpfik
dɹusɸiɹt	tɹʊspiɹt
snɛɹssneɹt	snɛɹssneɹd
bɹɔɹnet	pɹɔɹned
fiŋgɹes	fɪngɹes
siknoɹf	siknoɹf
fɹeɹlbɹiɹ	fɹeɹlpɹɪɹ
netpɸiɹf	netpfiɹf
filsnɛɹt	filsnɛɹt
lipgɹuɹl	lipkɹʊɹl
bɹestdɹon	pɹesttɹon
dɹeɸiɹt	tɹepiɹt
bɹiɹlβɔɹl	bɹiɹlbɔɹl
lɛfpɸɹiɹ	lɛfpfɹɪɹ
lɹuɹsgɹɔns	lɹʊɹskɹɔns
notbɹa	notpɹa
ɸubɹun	pupɹun
dɹiɹlɹuk	dɹɪɹlɹug
ɸɔsnɹun	pɔsnɹun
lɹɛnsgɹup	lɹɛnsgɹʊb
ɔsgɹuɹn	ɔskɹʊɹn
zodɸons	dodpons
dɹoɹdɹuɹf	tɹoɹdɹuɹf
bɹulqun	bɹulkʊn
dɹuɹdgɹiɹs	tɹuɹtkɹiɹs
bɹifɹuɹn	pɹɪfɹʊɹn
tsiɹmɸit	tsiɹnpit
bɹæstgɹɔɹl	bɹastkɹɔɹl
pɸægbɹuk	pfagbɹug
etpɸiɹf	etpfiɹf
fɹɔɹbsɹu	fɹɔɹpsɹʊ
fiɹɱfɹɔ	fiɹnfɹɔ
efnɹɔɹf	efnɹɔɹf
ɸɶɹsfɹɔp	paɹsfɹɔp
pɸuɹgseɹt	pfuɹgseɹd
sɹɔɹlleɹk	sɹɔɹlleɹk
fostsnæɹk	fostsnaɹg
ɸøɹfsɔl	peɹftɔl
pɸoɹdsufp	pfoɹdtʊfp
lɹibsɹuɹl	lɹɪbsɹʊɹl
byɹfgɹiɹt	bɪɹfkɹiɹd
dɹɛɹbɸuɹt	dɹɛɹbpʊɹd
gɹɛɹgsik	gɹɛɹgtɪk
ɣɛɹbɣɛf	gɛɹpgɛf
βoɹbsiɹp	boɹpsiɹb
snostfɔf	snostfɔf
zempɸik	denpfig
gɹoɹbfep	kɹoɹbfeb
bɹidtsofp	bɹɪdtsofp
pɸɔstdɹeɹk	pfɔsttɹeɹk
ustsɹek	ustsɹek
dɹokpɸoɹt	dɹokpfoɹd
fɹubɸust	fɹʊbpust
suɹsgɹɛl	tʊɹskɹɛl
ubzɔp	ubdɔp
βonsifp	bonsifp
sɹuɹbgɹuɹn	sɹʊɹbgɹʊɹn
dɹuɹgtsuɹp	dɹuɹgtsʊɹp
lɹestpɸɛ	lɹestpfɛ
qɔddɹip	kɔdtɹib
bɹɛɹfseɹp	pɹɛɹfteɹp
dɹunof	tɹunof
bɹipsɹɛɹs	bɹɪpsɹɛɹs
lɔdɹoɹt	lɔdɹoɹt
nileɹp	nɪleɹb
dæɹgɸuɹk	daɹgpʊɹg
lɹædbɹon	lɹadpɹon
lɹɔgfɹofp	lɹɔgfɹofp
ɹuknɹup	ɹuknɹʊb
næstlɛns	nastlɛns
fuppɸɔɹl	fʊppfɔɹl
fɹulɢop	fɹʊlgob
dɹɛfɹæk	tɹɛfɹag
sɹistxest	sɹɪstkest
ɸɔbfɔk	pɔbfɔg
sɹeɹbgɹæɹt	sɹeɹpkɹaɹd
fɹæɹbpyɹf	fɹaɹbpɪɹf
fæglɛt	faglɛt
lɹæɹdlust	lɹaɹdlust
βɶɹdβøn	baɹtben
fɹæɹbsɹæɹs	fɹaɹbsɹaɹs
sɹuɹdpɸoɹk	sɹʊɹdpfoɹg
ɢufpβiɹp	gʊfpbiɹp
nɛɹdlɹep	nɛɹdlɹep
sɹiɹfdɹuɹp	sɹɪɹfdɹʊɹb
ɣiɹldɹæk	giɹldɹak
zuksɹiɹs	dʊksɹɪɹs
bɹiɹlfɹɔɹp	pɹɪɹlfɹɔɹb
ɸuɹmβɔs	puɹnbɔs
fɹɛɹlnik	fɹɛɹlnɪg
lɹoɹsɣiɹk	lɹoɹsgiɹg
bɹudsel	bɹudsel
sɔnil	sɔnɪl
sudlɹiɹ	sʊdlɹiɹ
sidɹuɹt	tɪtɹuɹt
gɹiɹbbɹɛɹl	gɹiɹpbɹɛɹl
xɛdlɹɛp	kɛdlɹɛp
sɹumɸɔɹt	sɹʊnpɔɹd
βokbɹiɹp	bokbɹiɹp
gɹustxip	gɹʊstkɪp
gɹikbyɹ	gɹɪkbɪɹ
βufpɸæɹk	bufpfaɹk
sɛɹnæɹn	tɛɹnaɹn
zitdɹæɹf	dɪttɹaɹf
quɹgfɹɛɹs	kuɹgfɹɛɹs
snifæst	snifast
lɹɔdfiɹn	lɹɔdfɪɹn
dɹifgɹuɹt	dɹɪfkɹuɹt
gɹɛɹgquns	gɹɛɹgkuns
fɹifpbɹuɹs	fɹɪfppɹuɹs
zuɹfβɶɹt	duɹfbaɹd
ɸutdɹofp	pʊtdɹofp
sɹiɹŋqot	sɹɪɹnkod
niɹnlɹæɹt	niɹnlɹaɹt
sɔɹfdɹeɹt	sɔɹftɹeɹt
lɹokdɹɛp	lɹokdɹɛp
snuɹgtsɛst	snuɹgtsɛst
sɹufpbɹe	sɹʊfppɹe
gɹæɹfɹuɹ	gɹaɹfɹʊɹ
bɹeɹgsɹoɹ	pɹeɹksɹoɹ
lɹensgɹeɹp	lɹenskɹeɹp
snæɹŋgɹok	snaɹngɹog
quɹdxɛɹ	kuɹdkɛɹ
sɹeɹlgɹiɹt	sɹeɹlgɹiɹd
sɹɔnsnoɹf	sɹɔnsnoɹf
sɹidbɹup	sɹidpɹub
dɹæɹgtse	tɹaɹktse
nɹeɹzu	nɹeɹdʊ
dɹɛɹlbɹɛk	dɹɛɹlpɹɛg
gɹɔbsop	kɹɔbsob
niɹdluɹk	nɪɹtluɹk
zufpsoɹt	dufpsoɹd
uklɹip	uklɹib
lɹumbɹiɹl	lɹʊnpɹɪɹl
qɔɹgzi	kɔɹgdi
tsoɹsbɹip	tsoɹspɹɪp
tsugbɹot	tsʊgbɹod
βisgɹoɹl	bisgɹoɹl
nɛɹɱfɹot	nɛɹnfɹot
nɹifpβøst	nɹifpbest
fɹilzik	fɹɪldik
gɹɛfit	kɹɛfid
ɸɔdsnen	pɔdsnen
xeɹddɹɛk	keɹtdɹɛg
snæɹzufp	snaɹdufp
ɹiɹgɸœk	ɹiɹkpɛk
bɹændɹɛfp	bɹandɹɛfp
fɹunssik	fɹʊnstig
nɹusnɹoɹk	nɹʊsnɹoɹk
snoɹbnɹiɹt	snoɹpnɹɪɹd
nɹæslɹæɹk	nɹaslɹaɹk
gɹeffɹuɹl	gɹeffɹuɹl
bɹɛstgɹɔk	pɹɛstgɹɔk
snɛɹfβust	snɛɹfbust
fɛɹfɹop	fɛɹfɹob
bɹilɹoɹf	pɹɪlɹoɹf
ɸøɹɣit	peɹgɪd
zupquf	dʊpkuf
nɛftsit	nɛftsɪd
bɹæfβɔfp	bɹafbɔfp
lipsi	liptɪ
pɸiɹglɹɔɹf	pfɪɹglɹɔɹf
uɹlons	uɹlons
fɹɛdzɛɹt	fɹɛddɛɹt
sɹuɹgdæn	sɹʊɹgdan
lɹɔsɢoɹf	lɹɔsgoɹf
ɹɛdlɹæɹt	ɹɛdlɹaɹd
ɹitsnuɹn	ɹɪtsnuɹn
lælnuɹt	lalnʊɹd
gɹiɹbtsup	gɹiɹptsʊb
fɹiɹlgɹok	fɹɪɹlkɹok
gɹɔlβiɹk	kɹɔlbiɹk
bɹugdɹæp	bɹʊgtɹap
ɹukβɶɹp	ɹukbaɹb
dɹiɹnɛɹt	tɹiɹnɛɹd
nesttsofp	nesttsofp
ɸɶfpɸœɹp	pafppɛɹp
nunsnuɹp	nunsnuɹb
xiɹbyɹt	kiɹpɪɹd
nɹænsbɹofp	nɹansbɹofp
lɹɛfdɹiɹp	lɹɛftɹɪɹb
tsoɹdβɶns	tsoɹdbans
βupbɹop	bupbɹob
gɹeɹdxɛst	gɹeɹtkɛst
bɹilɣins	bɹɪlgins
ɹɛɹltæɹp	ɹɛɹltaɹb
sɹeɹbfɛɹs	sɹeɹbfɛɹs
nɹɔnsɣɛn	nɹɔnsgɛn
suknɹel	sʊknɹel
snotbɹek	snotbɹeg
zɔdxek	dɔdkek
nɹɛziɹt	nɹɛdɪɹt
gɹuɹβot	gɹuɹbod
βuplɹut	bʊplɹut
bɹænsfɹost	pɹansfɹost
soɹdnit	soɹtnɪd
pɸuɹlɢuɹt	pfʊɹlgʊɹt
dɹɛgbɹæs	tɹɛgpɹas
fɹoɹɢun	fɹoɹgun
snilɸuɹ	snilpuɹ
zifnek	difneg
ɢɔɹdniɹn	gɔɹtnɪɹn
nɹæflɹæk	nɹaflɹak
ɔsfiɹ	ɔsfiɹ
ɢustsnɛt	gʊstsnɛt
bɹiɹdɸiɹp	bɹɪɹdpiɹp
ɢuɹbsol	gʊɹpsol
qoɹgbɹip	koɹgpɹɪp
fiɹblɹuɹn	fiɹblɹuɹn
ɹɛnssɔp	ɹɛnssɔp
lundæɹn	lundaɹn
qɔkfɹun	kɔkfɹun
ɸøsɣiɹs	pesgiɹs
pɸiglɔɹt	pfɪglɔɹd
xensɹæk	kensɹag
pɸiɹfnɛt	pfiɹfnɛt
fegɹif	fekɹif
gɹeɹbɹiɹn	kɹeɹbɹiɹn
neɹbnɹæk	neɹpnɹag
sɔstɸuɹs	sɔstpʊɹs
snufpbɹil	snufpbɹɪl
snænnɹiɹp	snannɹɪɹp
ɸotsnæɹt	potsnaɹd
ɹustlef	ɹustlef
tæfpsɹik	tafpsɹɪg
dɹufbɹut	tɹʊfpɹʊd
fæfpɸiɹk	fafpfɪɹg
ɸukgɹæɹk	pʊkgɹaɹg
dɹɔbɢɔɹt	dɹɔbgɔɹt
tsuɹgsɹɔk	tsuɹgsɹɔk
nɔɹlpɸip	nɔɹlpfɪb
ɸøksofp	peksofp
ɹimbɹe	ɹɪnpɹe
βœttsɔn	bɛttsɔn
dɹuszɛfp	dɹusdɛfp
lɹistfɹoɹl	lɹistfɹoɹl
bɹæɹdɸœɹk	pɹaɹtpɛɹk
lokzik	lokdɪk
gɹiɹgnɹæk	kɹiɹgnɹak
lɹogdɹup	lɹogtɹʊp
dɹustsɹiɹs	tɹustsɹɪɹs
lupnɹut	lupnɹʊd
ɹitgæɹt	ɹitgaɹt
nukɸuɹ	nukpuɹ
ɹuɹbfɛɹt	ɹʊɹbfɛɹd
lukziɹf	lʊkdɪɹf
lɹifsnɔl	lɹɪfsnɔl
dɹilzoɹs	tɹɪldoɹs
gɹostβil	kɹostbil
tsægdɹoɹf	tsagtɹoɹf
gæfpsnons	gafpsnons
gɹudɹon	gɹudɹon
ɹɛktsup	ɹɛktsub
qulɸik	kʊlpig
nɹɛɹdɣeɹ	nɹɛɹtgeɹ
snuɹbqoɹt	snuɹbkoɹt
bɹuɹbqut	pɹʊɹbkʊt
fɹɔfɸuɹl	fɹɔfpuɹl
snɔɹdsɹæf	snɔɹtsɹaf
ɣiɹsɹiɹk	gɪɹsɹɪɹk
gɹoɹɹeɹk	gɹoɹɹeɹk
lɹæɹsɹip	lɹaɹsɹib
sɹuɹgtsost	sɹuɹgtsost
lebgɹɛns	lebgɹɛns
βɶɹdsnɔk	baɹdsnɔg
suɹdbɹuns	suɹdbɹuns
sepxip	sepkip
gɹufpɸɹul	kɹufpfɹul
bɹæɹftsuɹn	bɹaɹftsuɹn
lɹoɹgnoɹt	lɹoɹgnoɹd
sneɹsɸok	sneɹspog
nɹofppɸet	nɹofppfet
dɹepɸist	dɹepfist
ziɹblɹiɹp	diɹblɹɪɹb
læbfik	labfɪk
nɹollɹep	nɹollɹep
gɹonsɢɔt	kɹonsgɔd
fɔɹlnɹip	fɔɹlnɹip
dɹuftsɔp	tɹʊftsɔp
suɹgtsuɹl	tuɹgtsʊɹl
tæpsek	tapseg
ɹæɹbsɹɛɹp	ɹaɹpsɹɛɹp
niɹldɹɔf	niɹldɹɔf
βœɹftseɹk	bɛɹftseɹg
qotsɛɹt	kottɛɹd
soɹdsoɹf	soɹdtoɹf
xɛɹnlest	kɛɹnlest
βistlul	bistlʊl
ziɹdɹust	dɪɹtɹʊst
zutlɔɹk	dʊtlɔɹk
bɹɛsbɹɛf	bɹɛspɹɛf
gɹæɣɛɹf	gɹagɛɹf
ansful	ansful
ɸuɹddɹil	puɹdtɹɪl
sɹiɹzɛl	sɹiɹdɛl
lɔnssɔst	lɔnssɔst
gɹoɹdzuɹt	kɹoɹdduɹt
βupɸɹuk	bʊpfɹʊk
leɹin	leɹin
sɹikβœfp	sɹikbɛfp
nɹɛlsɹæɹs	nɹɛlsɹaɹs
sefppyk	tefppɪg
bɹɔbyɹk	bɹɔbɪɹk
futdɹiɹl	fʊttɹɪɹl
nɹiɹbnɛl	nɹɪɹbnɛl
fɹɛɹniɹn	fɹɛɹnɪɹn
sɹɔkful	sɹɔkful
tsistsɹɔp	tsɪstsɹɔp
dɹɛnsdɹɔɹ	tɹɛnsdɹɔɹ
sɔsdɹup	sɔstɹub
gɹuɹniɹf	gɹʊɹnɪɹf
nɹopbɹuɹ	nɹoppɹuɹ
ɹoeɹn	ɹoeɹn
bɹiɹeɹp	bɹiɹeɹp
ɛdɹɔp	ɛtɹɔp
ɹuspɸeɹn	ɹuspfeɹn
sæsqɔɹt	saskɔɹt
dɹifpsæf	dɹifpsaf
suɹbɹuk	suɹbɹug
ɣɛpɸuɹf	gɛpfuɹf
bɹifnɹot	pɹɪfnɹod
lɹumbɹeɹf	lɹunbɹeɹf
gɹɛlsiɹl	kɹɛltɪɹl
dɹɔɹgdɹiɹs	tɹɔɹktɹɪɹs
ɹoɹbsuɹt	ɹoɹpsuɹt
βɔpɸot	bɔpfod
qulɸɶɹt	kʊlpaɹd
fifptsɔɹ	fifptsɔɹ
βoɹgbɹufp	boɹkpɹʊfp
dɹæɹftæfp	tɹaɹftafp
nɔɹsnɔɹk	nɔɹsnɔɹk
seflɹɛst	teflɹɛst
ɸɔɹgbyɹk	pɔɹgbɪɹk
uɹbɸøɹp	ʊɹbpeɹp
zusdɹoɹt	dʊstɹoɹt
dɹɔɹgtsil	tɹɔɹgtsil
tsɛpzɔns	tsɛpdɔns
lɹuβøl	lɹʊbel
dɹifpbɹuf	tɹɪfpbɹʊf
bɹobβop	pɹobbob
bɹitfa	bɹitfa
lɹikfɹæɹt	lɹɪkfɹaɹd
dɹæɹgβœk	tɹaɹkbɛg
dɹinstsiɹf	dɹinstsiɹf
gɹeɹnif	gɹeɹnɪf
ɣeɹblɹuɹn	geɹblɹʊɹn
nɹæddɹɛl	nɹaddɹɛl
bɹiɹbfɹiɹf	bɹiɹbfɹɪɹf
snɛɹdsup	snɛɹdsʊp
niltsuɹl	nɪltsʊɹl
siɹdnoɹp	tɪɹtnoɹb
bɹeɹdpɸit	bɹeɹdpfit
nɹɔɹfnɹiɹ	nɹɔɹfnɹiɹ
bɹefɔɹ	bɹefɔɹ
bɹuɹdnoɹs	pɹuɹtnoɹs
dɹogbɹɛɹk	dɹogbɹɛɹk
bɹeplufp	bɹeplufp
sɹufzuɹ	sɹufduɹ
dɹæstsɛ	dɹasttɛ
gɹænsgɹuɹk	gɹanskɹuɹg
lɹæɹzuɹs	lɹaɹduɹs
siktsa	siktsa
ɹɛsqoɹt	ɹɛskoɹt
gɹæseɹt	kɹateɹd
ɸuɹbɣens	puɹpgens
fɹudtsut	fɹudtsʊd
ɣimpɸɔɹl	ginpfɔɹl
dɹɔfpɸoɹ	tɹɔfpfoɹ
sniɹmbɹins	sniɹnpɹins
ɹæfɸœ	ɹafpɛ
bɹiɹddɹɛɹk	bɹiɹtdɹɛɹk
noɹbɸɔp	noɹppɔp
tsoɹbgɹɔp	tsoɹpkɹɔb
dɹodɹɔl	tɹotɹɔl
eɹmbɹust	eɹnbɹust
nɹoɹdɹiɹp	nɹoɹdɹɪɹp
gɹiɹfsnɛɹk	kɹiɹfsnɛɹk
lɹæɹbpɸɛst	lɹaɹppfɛst
sɹɛɹbsɛs	sɹɛɹbtɛs
nodfɹiɹk	nodfɹiɹk
pɸɔɹlpɸɔst	pfɔɹlpfɔst
bɹuɹbbɹiɹp	pɹʊɹppɹiɹb
tsɛstlɹuɹp	tsɛstlɹʊɹp
ɣiɹbsins	giɹpsins
nɔfdɹin	nɔfdɹin
dɹefsɛɹt	tɹeftɛɹt
qunsɢɔk	kʊnsgɔg
sullɹɔk	sullɹɔk
pɸosgɹiɹp	pfosgɹiɹb
dɹinsbɹis	dɹinspɹis
dɹɔɹdnens	tɹɔɹdnens
zuŋxɛɹ	dʊnkɛɹ
suɹbɢuɹt	tuɹbguɹt
soɹsɸɔp	toɹspɔp
lɹoɹsɸol	lɹoɹspol
gɹoɹlsæfp	gɹoɹlsafp
dɹefpdɹɔp	tɹefpdɹɔp
sɔpdɹep	tɔptɹep
sutsɹut	tʊtsɹud
pɸuɹbbɹɛɹt	pfuɹbbɹɛɹt
pynsgɹɛk	pɪnskɹɛg
dɹelɹip	tɹelɹɪp
gɹuɣeɹp	kɹʊgeɹp
ɹitdɹɛɹp	ɹɪttɹɛɹb
noɹbset	noɹbsed
βøfppyɹn	befppɪɹn
dɹoknɹæst	tɹoknɹast
bɹeɹbbɹuk	bɹeɹbbɹʊg
dɹiɹdsɹip	tɹiɹdsɹip
zuɹbɹins	dʊɹpɹɪns
bɹiɹmβɶns	pɹɪɹnbans
gɹultsel	gɹʊltsel
nɹɔksoɹn	nɹɔksoɹn
nɹæsgɹust	nɹasgɹust
gɹukdɹin	gɹʊkdɹin
ɸɔɹbnɹuɹs	pɔɹbnɹuɹs
xiɹbgɹus	kɪɹpkɹʊs
pɸustɢuɹk	pfustguɹg
pɸæɹbdɹɛs	pfaɹpdɹɛs
βodβøɹt	bodbeɹt
ɣeɹmɸɶf	geɹnpaf
uɹdɢut	uɹtgʊd
lɔxɛɹt	lɔkɛɹd
fonsfɹɔɹk	fonsfɹɔɹg
lɹɛtneɹp	lɹɛtneɹp
bɹobtsist	bɹobtsist
ɸœɹnnɹiɹt	pɛɹnnɹiɹt
snoɹsɛɹp	snoɹsɛɹb
sɹiɹfɹut	sɹɪɹfɹud
ɹɛgbɹef	ɹɛgpɹef
dɹifgɹup	tɹifgɹʊb
nuɹblæɹn	nʊɹblaɹn
lɛɹstsɔ	lɛɹstsɔ
zɛbbɹuk	dɛbpɹʊk
lɹegpɸæɹp	lɹegpfaɹp
nistlil	nɪstlil
gɹilɸust	kɹilpʊst
gɹiɹgsiɹp	kɹiɹktiɹb
snuɹdtsɛp	snuɹttsɛb
dɹutsɹeɹk	tɹutsɹeɹg
ɸønæk	penak
fɹogsnit	fɹogsnɪt
fɹuɹŋɣil	fɹʊɹngɪl
soɹdsɹɛf	toɹtsɹɛf
gɹæɹgqɔfp	kɹaɹkkɔfp
linsɹæp	lɪnsɹab
nɛfpzeɹt	nɛfpdeɹt
ɹuɹnɹɛɹk	ɹʊɹnɹɛɹk
nognɹɛk	nognɹɛk
nɛdgɹip	nɛdgɹɪp
siɹssniɹp	siɹssnɪɹb
nɹɛdpɸoɹs	nɹɛdpfoɹs
ɸuksiɹp	puksiɹb
bɹæbgɹiɹ	bɹabgɹiɹ
dɹuɹdfost	dɹʊɹdfost
βunsɛn	bʊnsɛn
gɹeɹldɹif	gɹeɹldɹif
bɹunspɸɔɹk	pɹʊnspfɔɹk
snuɹdlɹik	snuɹdlɹɪg
dɹeɹfzeɹp	dɹeɹfdeɹb
nɹɛstqust	nɹɛstkʊst
kæɹbɹæt	kaɹbɹat
fɹɔɹddɹep	fɹɔɹddɹeb
snuɹsnɹeɹl	snuɹsnɹeɹl
xistqufp	kistkʊfp
tsɛɹgtsɔt	tsɛɹgtsɔd
bɹɔɹlɹiɹp	pɹɔɹlɹiɹb
dɹɛɹbnɹul	dɹɛɹbnɹʊl
lupsins	lʊptɪns
sɹeɹŋgɹɔɹk	sɹeɹnkɹɔɹg
fobɹes	fopɹes
zeɹbɢun	deɹpgʊn
bɹugzi	pɹugdɪ
xise	kite
bɹeɹdsest	pɹeɹtsest
fɔpniɹk	fɔpnɪɹg
dɹufɸøn	tɹufpen
dɹɛfdɹa	tɹɛfdɹa
bɹegtsæɹt	bɹegtsaɹt
fɹodgɹæk	fɹodkɹag
dɹiɹŋɣɛs	dɹɪɹngɛs
ɸɶggɹul	pagkɹʊl
ɸøstbɹes	pestpɹes
tsɔɹsbɹɔst	tsɔɹspɹɔst
gɹulniɹ	gɹʊlnɪɹ
dɹutβoɹk	dɹutboɹg
tsoɹldɹit	tsoɹldɹɪd
sɹɔɱfɛns	sɹɔnfɛns
ɹoɹdɹofp	ɹoɹdɹofp
lɹiɹffɹof	lɹiɹffɹof
ɛɹnɹip	ɛɹnɹɪb
sɔnssnɛp	sɔnssnɛb
lɹoɹdzɔɹf	lɹoɹddɔɹf
gɹɔɹnlɹeɹt	kɹɔɹnlɹeɹd
dɹɔɹfeɹf	tɹɔɹfeɹf
lɹunsgɹeɹn	lɹʊnskɹeɹn
dɹisfoɹn	dɹisfoɹn
sistgɹæl	sɪstgɹal
ɸoɹlniɹn	poɹlnɪɹn
dɹæɹsfe	dɹaɹsfe
fɛɹldɹoɹt	fɛɹldɹoɹt
ɸutpɸul	putpful
dɹɔŋgɹik	tɹɔnkɹɪg
nɹofæɹn	nɹofaɹn
zoɹbbɹɛ	doɹbpɹɛ
ɸɶɹdsnæɹl	paɹtsnaɹl
βœpluf	bɛplʊf
zepsnæɹn	depsnaɹn
snuɹnnik	snʊɹnnɪg
ɹiɹbdɹeɹt	ɹɪɹbdɹeɹt
loɹsuns	loɹsuns
sɹoɹdzeɹt	sɹoɹddeɹd
gɹɔnsβœɹl	gɹɔnsbɛɹl
fɹikzuɹk	fɹikduɹg
ɹæɹsli	ɹaɹsli
ɹæɹddɹiɹn	ɹaɹtdɹiɹn
ɢɔɹlsnɔɹk	gɔɹlsnɔɹg
zupɸiɹp	dʊpfiɹb
fiɹbniɹt	fiɹbniɹt
zɛɹlsɹɔɹt	dɛɹlsɹɔɹt
sɔdsufp	sɔdsufp
ɸøɹgbɹoɹn	peɹkpɹoɹn
ɹostnɹa	ɹostnɹa
siɹlgɹɛɹp	tɪɹlkɹɛɹp
sɔɹdfuɹp	sɔɹtfʊɹb
adnek	adneg
pɸiɹsɹop	pfɪɹsɹop
dɹebɹil	dɹebɹɪl
bɹesbɹuɹp	pɹesbɹʊɹp
gɹɔɹdgɹuf	gɹɔɹtgɹʊf
dɹolins	tɹolins
nɹæpdɹoɹl	nɹapdɹoɹl
fɹuɹglɹiɹk	fɹuɹglɹiɹg
gɹuɹntsiɹp	kɹʊɹntsɪɹp
fistsnɔfp	fistsnɔfp
nifluɹ	nɪflʊɹ
ɹissnis	ɹissnis
oɹɱfɹiɹp	oɹnfɹiɹb
pyɹgdɹuɹt	pɪɹgtɹʊɹt
gɹoɹnzɛl	kɹoɹndɛl
pɸɛɹbɹæt	pfɛɹpɹad
βugdɹist	bʊgdɹɪst
sɹufsnɔn	sɹufsnɔn
pɸɔgɢul	pfɔggʊl
sɹillɹist	sɹillɹist
fɹɔɹsdɹæns	fɹɔɹsdɹans
dɹiɹnzoɹp	dɹiɹndoɹp
bɹɛnsfɹæfp	pɹɛnsfɹafp
nɹufæp	nɹufap
bɹɛɹftæl	bɹɛɹftal
tsɔsdɹɛɹl	tsɔstɹɛɹl
bɹoɹbɢɔk	bɹoɹbgɔg
dɹɔfdɹok	tɹɔfdɹok
dɹænop	dɹanob
qolβup	kolbub
ziɹstsup	dɪɹstsub
zifit	difid
nɹogɹi	nɹogɹi
lutfɹoɹk	lʊtfɹoɹk
tsoɹdbɹɛɹs	tsoɹdbɹɛɹs
pɸeɹgnɹuɹl	pfeɹknɹuɹl
ɹuɹdɹɔɹf	ɹuɹtɹɔɹf
βœɹfsa	bɛɹfsa
fɹædɸiɹk	fɹadpiɹg
sɹelseɹl	sɹelseɹl
gɹoɹlpɸɔns	gɹoɹlpfɔns
gɹæfpdɹin	gɹafpdɹɪn
fɹæɹntsɔl	fɹaɹntsɔl
dɹæɹgsniɹt	tɹaɹksnɪɹt
fuɹbsneɹp	fʊɹpsneɹp
zuɹgbɹæɹt	dʊɹgbɹaɹd
lɹæɹgpɸik	lɹaɹgpfik
ɢubɹins	gubɹɪns
bɹessnuɹt	bɹessnuɹt
quksæp	kuksab
ɹɛtgɹeɹt	ɹɛtkɹeɹd
ɹogɹuk	ɹogɹʊk
dɹælɢut	dɹalgʊt
fɹenssɔɹk	fɹenssɔɹk
pɸudɢɔfp	pfudgɔfp
dɹuɹnsufp	dɹuɹntʊfp
bɹufpsit	pɹufptɪd
bɹuɹbbɹist	bɹʊɹbbɹist
qoɹbfuɹf	koɹpfʊɹf
nuɹlpɸit	nuɹlpfɪt
nɹuɹndɹiɹn	nɹʊɹndɹɪɹn
ibbɹif	ibpɹif
ɸɶstfɹɛɹk	pastfɹɛɹk
qoɹgquk	koɹgkug
pɸelnɹoɹt	pfelnɹoɹd
sedsnæɹ	sedsnaɹ
soglɹep	toglɹep
bɹiɹbtsiɹk	pɹiɹbtsɪɹg
ɹildɹiɹp	ɹiltɹɪɹp
ɸupnut	pupnʊt
quɹbpɸɛɹt	kuɹppfɛɹt
ɸøɹssniɹk	peɹssniɹk
dɹuɹndɹuɹk	tɹʊɹndɹʊɹk
βœttsut	bɛttsʊd
ɢɔɹdbɹi	gɔɹdpɹɪ
zɔɹɱfɹæl	dɔɹnfɹal
snæɹbsiɹs	snaɹbsiɹs
tsutsɛɹp	tsutsɛɹb
βøtfɔt	betfɔt
uɹdɸuk	ʊɹdpug
nuɹgbɹæɹ	nʊɹgpɹaɹ
sɹepdɹul	sɹepdɹul
sɹibfɹuɹt	sɹibfɹuɹd
insdɹifp	instɹɪfp
βɔmɸɶns	bɔnpans
snɔɹbgɹɔs	snɔɹpgɹɔs
zuɹdfɹiɹk	dʊɹdfɹiɹg
fɹiɹgɣit	fɹɪɹggid
sɔɹset	tɔɹset
fɹussnɔp	fɹʊssnɔp
pɸɔɹfɣɛl	pfɔɹfgɛl
bɹofɣiɹ	pɹofgiɹ
ɸotβœk	potbɛg
dɹiɹssuf	tɹiɹstʊf
snɔɹgpɸol	snɔɹgpfol
sniɹbnɹoɹt	snɪɹbnɹoɹd
pydɹæɹt	pɪdɹaɹd
ɣiɹnsɹuɹf	giɹnsɹʊɹf
ɹɔdɹuk	ɹɔdɹug
bɹuɹbdɹiɹf	bɹʊɹpdɹɪɹf
nɛdnuɹk	nɛdnuɹg
βuɹbsɔt	bʊɹbsɔd
tsɛggɹiɹf	tsɛggɹiɹf
nubnɹɔn	nubnɹɔn
sɹæɹfuɹs	sɹaɹfuɹs
lɹɔɹgdɹiɹn	lɹɔɹktɹiɹn
soŋɢun	tongʊn
soɹgɣiɹt	soɹggiɹt
sæbsɹæɹk	sabsɹaɹg
zɔnsnon	dɔnsnon
fɔɹdpɸæns	fɔɹtpfans
bylne	bɪlne
dɹofpɸef	dɹofpfef
ɹuplɹuɹn	ɹʊplɹʊɹn
fɹɛlqɔp	fɹɛlkɔp
gɹɔɹlsɹɔp	gɹɔɹlsɹɔb
gɹeɹfsɹɔɹk	gɹeɹfsɹɔɹk
ɹodɸɔɹl	ɹodpɔɹl
gɹostsus	gɹostsʊs
tæseɹp	taseɹp
sɹoknɹeɹp	sɹoknɹeɹb
snæɹgɹɔɹt	snaɹkɹɔɹt
ɸɶtfɛɹt	patfɛɹt
ɸiɹlfɹut	piɹlfɹʊd
ɛnstsɔɹt	ɛnstsɔɹt
nesnuf	nesnʊf
ɛɱfɹoɹn	ɛnfɹoɹn
noplɹɔfp	noplɹɔfp
nɛpɸɹɛɹl	nɛpfɹɛɹl
dɹeɹbbɹuɹp	tɹeɹppɹʊɹp
ziɹddɹin	dɪɹtdɹɪn
qoɹdsɹust	koɹtsɹust
sɹæbfɹɔɹt	sɹabfɹɔɹd
xiɹbquk	kɪɹpkʊk
snæɹlɹins	snaɹlɹɪns
bɹilɹɛl	bɹɪlɹɛl
ɸistfɹuɹp	pistfɹuɹb
ɹinsnip	ɹinsnɪb
gɹɔɹflɹɔk	kɹɔɹflɹɔg
ɹuɹgbɹik	ɹʊɹkpɹɪk
bɹæɹgbɹæɹp	pɹaɹkpɹaɹb
zuɹlɹons	dʊɹlɹons
bɹuɹzoɹp	bɹʊɹdoɹp
gɹuɹŋgɹol	kɹʊɹnkɹol
nɹeɹbgɹɛst	nɹeɹpkɹɛst
dɹoɸɔ	tɹopɔ
tsoɹdlɛɹp	tsoɹtlɛɹp
fɹɛɹŋgɹɔɹp	fɹɛɹnkɹɔɹb
qoɹdɹɛɹp	koɹdɹɛɹp
sɛɹfɹɔn	tɛɹfɹɔn
dɹiɹfbɹɔp	dɹiɹfpɹɔb
lɹutses	lɹʊtses
snuɹbtsɛf	snʊɹptsɛf
lɔggæfp	lɔggafp
nufppɸiɹp	nʊfppfiɹp
gɹiksɛn	gɹiktɛn
xiɹdɹæn	kiɹdɹan
lɹitnik	lɹitnɪk
fɛɹglɹens	fɛɹklɹens
lɛppɸɛ	lɛppfɛ
ulfɹuɹ	ʊlfɹʊɹ
filβot	fɪlbod
tsiɹfbɹu	tsiɹfbɹʊ
fɹiɹnɹɛst	fɹɪɹnɹɛst
bɹiɹmbɹu	pɹɪɹnpɹʊ
dɹuɹltsuns	tɹʊɹltsuns
ɢɔɹdfɹɔt	gɔɹdfɹɔd
bɹɛŋgɹeɹt	bɹɛnkɹeɹd
bɹɛɹdzuk	pɹɛɹddʊk
gɹætqɔk	kɹatkɔg
nɹoɹbfɹæɹt	nɹoɹbfɹaɹt
ɹɔɹflæt	ɹɔɹflat
ɣeɹut	geɹut
ɹenslæst	ɹenslast
bɹɛɹbzul	pɹɛɹbdul
ɸœplel	pɛplel
nɹæɹflɹeɹt	nɹaɹflɹeɹt
sɹoddɹɛn	sɹodtɹɛn
sɛɹbquɹf	sɛɹpkuɹf
snæɹnol	snaɹnol
zuɹftæs	duɹftas
pyɱfiɹp	pɪnfiɹb
ɹeblɔst	ɹeblɔst
pɸɛblɔns	pfɛblɔns
gɹuɹlɣiɹf	gɹʊɹlgɪɹf
fɹefpnɹu	fɹefpnɹʊ
astnɹoɹs	astnɹoɹs
dɹɛɹdnɹip	tɹɛɹtnɹɪb
ɸulbɹɔɹn	pulbɹɔɹn
gɹulgɹæɹl	kɹulkɹaɹl
fuɹdɸœt	fuɹdpɛd
βɶpnɔp	bapnɔp
gɹɔpbɹul	gɹɔppɹʊl
fæsnæɹt	fasnaɹd
fɹumbɹiɹf	fɹunbɹɪɹf
ɹutbɹiɹf	ɹutpɹɪɹf
sɹɛfxik	sɹɛfkik
senssiɹt	senssɪɹt
ɸødbɹæl	pedbɹal
bɹiɹmbɹis	pɹiɹnbɹis
lɹeɹbpɸuɹf	lɹeɹppfuɹf
ɸuɹdfɔɹl	puɹdfɔɹl
ɣiɹfsɹiɹk	gɪɹfsɹɪɹk
gɹæɹgpɸɔl	kɹaɹkpfɔl
zigɸuɹk	digpʊɹg
gɹineɹf	kɹineɹf
fæɹdlok	faɹtlog
βœɹmpɸɛst	bɛɹnpfɛst
siɹdβofp	siɹdbofp
sɹegsnɛp	sɹegsnɛb
gɹeɹgdɹoɹp	gɹeɹkdɹoɹp
niɹgnɹɛl	niɹgnɹɛl
lɹɔɹbsiɹl	lɹɔɹbsɪɹl
nɹinsɹæt	nɹɪnsɹat
dɹiɹlgɹoɹp	dɹiɹlgɹoɹb
uɹdsnul	uɹtsnʊl
ɹegsnon	ɹegsnon
tsuɹlnuk	tsʊɹlnʊg
lɹuɹnnɹeɹl	lɹʊɹnnɹeɹl
lɛgpɸeɹn	lɛgpfeɹn
liɹggɹeɹk	liɹkkɹeɹg
zɔɹdtsɛst	dɔɹdtsɛst
siɹldɹɛ	siɹltɹɛ
gɹɛfpɸɹeɹn	kɹɛfpfɹeɹn
ɢudgɹist	gudgɹist
nɹuɹdbɹɛt	nɹuɹdpɹɛd
sɹidbɹut	sɹɪdpɹʊt
ɣɛsɢus	gɛsgʊs
bɹoɹfuɹs	pɹoɹfuɹs
eɹzɛl	eɹdɛl
finsuɹk	fɪntʊɹk
bɹekɣiɹk	bɹekgɪɹg
loɹgpɸɛp	loɹgpfɛb
ɣiŋgɹit	gingɹɪt
pydsæt	pɪdsat
sindɹæɹ	sintɹaɹ
dɹɛpbɹi	dɹɛpbɹɪ
fɛɹsɣil	fɛɹsgɪl
pɸɛklɛɹk	pfɛklɛɹg
sunslɹæɹt	tʊnslɹaɹd
lɹinzot	lɹɪndot
fɹɛɹmpɸuns	fɹɛɹnpfʊns
ɸitliɹt	pitlɪɹt
ensɣist	ensgist
ɸonsɛns	pontɛns
ɢɔɹsɸœt	gɔɹspɛd
bɹɔnlɹiɹp	pɹɔnlɹiɹb
suɹbɣit	suɹbgɪt
ɢussɔ	gustɔ
lɛfpɸɔk	lɛfppɔg
bɹinssil	bɹɪnssɪl
iɹbβœɹp	iɹpbɛɹp
oɹlbɹuf	oɹlpɹʊf
quɹbseɹn	kʊɹpteɹn
snoɹlfins	snoɹlfɪns
siɹssɹik	sɪɹssɹik
gɹuɹbloɹl	gɹuɹbloɹl
sɹɛgɸuk	sɹɛgpuk
gætsif	gattif
pydɸoɹp	pɪdpoɹp
loɹɱfɹos	loɹnfɹos
tsæmpɸuns	tsanpfuns
ikzɛɹl	ikdɛɹl
zɛɹltsof	dɛɹltsof
pypsnɛf	pɪpsnɛf
zifsnæk	difsnag
dɹɔtsest	tɹɔtsest
pɸuɹblɹeɹs	pfʊɹplɹeɹs
bɹiŋgɹæs	pɹingɹas
suɹlsoɹk	sʊɹlsoɹk
lɹælkæn	lɹalkan
ɣɛstsɹɛs	gɛstsɹɛs
gɹufɹuɹs	gɹʊfɹʊɹs
ɸobnæp	pobnap
gɹɔɹbβɶɹn	kɹɔɹbbaɹn
sɹɔdɸufp	sɹɔdpʊfp
nulbɹuɹn	nʊlbɹuɹn
xisnit	kɪsnit
bɹistlɹɔɹf	bɹistlɹɔɹf
tsokluɹp	tsokluɹp
fɹoɹstsul	fɹoɹstsul
ɸɶpsnoɹ	papsnoɹ
lɔɹbɢoɹ	lɔɹpgoɹ
ɸøfɹus	pefɹus
siɹzɛɹ	sɪɹdɛɹ
sisβɔɹl	sisbɔɹl
nɹoɹlβul	nɹoɹlbʊl
nɔɹsbɹup	nɔɹspɹup
pɸestlɹæp	pfestlɹap
bɹeɹgsiɹl	pɹeɹktiɹl
pɸiɹɱfɹut	pfiɹnfɹʊt
sɹitluɹk	sɹitluɹk
xendɹufp	kendɹʊfp
dɹufpβœns	dɹʊfpbɛns
bɹænɹop	pɹanɹop
pɸælbyɹp	pfalbɪɹp
sɹæssup	sɹassʊb
bɹessnuɹ	bɹessnuɹ
dɹiɹbsɹuns	tɹɪɹpsɹuns
gɹobpɸo	gɹobpfo
sɹogbɹuɹp	sɹogpɹʊɹp
ɣɛɹgnæn	gɛɹknan
gɹeɹnnoɹn	gɹeɹnnoɹn
dɹublɹef	dɹublɹef
dɹopbɹiɹs	tɹoppɹiɹs
βɶɹbfɹuk	baɹpfɹuk
fobfɹut	fobfɹut
gɹegsɹeɹl	gɹegsɹeɹl
ɹɛfnut	ɹɛfnʊd
nɛsɸoɹl	nɛspoɹl
snibɹɛf	snibɹɛf
nistɣiɹf	nistgiɹf
nɹɔɹfip	nɹɔɹfɪb
snoɹglɹɔfp	snoɹklɹɔfp
xeɹβoɹt	keɹboɹt
pɸɔlɸoɹt	pfɔlpoɹt
zegfɔɹl	degfɔɹl
ɔɹddɹiɹn	ɔɹdtɹiɹn
sezis	tedis
bɹɛɹdɸop	bɹɛɹdpob
bɹostsut	pɹosttut
fæfsɹi	fafsɹɪ
gɹɔɹβif	gɹɔɹpif
zogpyfp	dogpɪfp
nɹofpβiɹs	nɹofpbiɹs
nɹunspyɹp	nɹunspɪɹb
gɹuɹbbɹens	gɹuɹppɹens
fudfɹit	fudfɹɪd
liɹbbɹuns	liɹppɹuns
bɹinsbɹek	bɹɪnspɹek
tsoɹfxi	tsoɹfki
tæpnɹæst	tapnɹast
bɹɛfpβɶɹn	pɹɛfpbaɹn
supɸup	sʊppup
quɹbqoɹs	kuɹbkoɹs
sudgɹup	sʊdgɹʊb
bɹukbɹeɹn	pɹukbɹeɹn
pɸɔkdɹuɹk	pfɔkdɹuɹg
pystpɸiɹt	pɪstpfiɹd
sunsgɹɛɹs	tʊnsgɹɛɹs
dɹɔgbɹiɹp	dɹɔgbɹɪɹp
dɹɛfpdɹif	dɹɛfpdɹɪf
tætgɹuɹf	tatgɹuɹf
ɸupqɔfp	pupkɔfp
pɸutsnɛɹl	pfutsnɛɹl
læɹdsnɔt	laɹtsnɔd
lɹiɹgdɹiɹn	lɹɪɹktɹiɹn
fɛɹbfɹɛɹp	fɛɹbfɹɛɹp
lɹɔɸu	lɹɔpu
feɹdsit	feɹdtɪd
eddɹæɹ	edtɹaɹ
bɹistlɹins	pɹɪstlɹins
sɔnspɸil	tɔnspfɪl
ɢobɹef	gobɹef
eɹbbɹon	eɹbpɹon
loɹɢuɹp	loɹgʊɹp
sɹuktæn	sɹʊktan
nɹesnɹɔf	nɹesnɹɔf
βutfɹuɹt	bʊtfɹʊɹd
bɹeszons	bɹesdons
luzɔp	ludɔb
dɹonsuk	tɹonsug
pɸɔstqons	pfɔstkons
ɸøstfæɹl	pestfaɹl
pɸeɹgtsæp	pfeɹktsap
lɹuksɹif	lɹuksɹɪf
fɛlɢuk	fɛlgʊg
liɹdgɹup	lɪɹtkɹʊb
gɹistluns	gɹistluns
ɹɛɹdfɹet	ɹɛɹdfɹed
ensxist	enskɪst
dɹoɹfsɔst	dɹoɹfsɔst
zɛkxɛp	dɛkkɛp
fikdɹæn	fiktɹan
bɹuɹgɹiɹ	bɹuɹkɹiɹ
ɸuɹniɹt	pʊɹnɪɹt
selɣɛs	selgɛs
gɹofpsnuɹp	gɹofpsnuɹp
fɹæɹdɸɶɹl	fɹaɹtpaɹl
ziɹdfis	dɪɹtfɪs
ɸɶɹfbɹuk	paɹfbɹʊk
ɔfɸœɹs	ɔfpɛɹs
snufsnil	snʊfsnɪl
ɹetsneɹk	ɹetsneɹg
lonsβiɹl	lonsbiɹl
nɹɛɹsfɹel	nɹɛɹsfɹel
bɹæɹgsæp	pɹaɹksap
nɛmbɹuɹp	nɛnbɹʊɹb
foɹnnɹok	foɹnnɹok
tsæɹgɸiɹk	tsaɹkpiɹg
ɸøɹflæɹl	peɹflaɹl
ɔlsɹɛ	ɔlsɹɛ
sudleɹk	sudleɹk
bɹɛɹbsoɹl	bɹɛɹbsoɹl
dællɹip	dallɹip
xeɹndɹun	keɹndɹʊn
iɹdso	ɪɹtso
sɹeɹdluɹp	sɹeɹtluɹb
sɹɛgpɸuɹp	sɹɛgpfʊɹb
ɔɹdfiɹt	ɔɹdfɪɹt
gɹubnuɹf	gɹubnʊɹf
dɹɔfpɸɹuk	dɹɔfpfɹuk
fɹufsɹus	fɹʊfsɹʊs
niɹbɹɛf	niɹbɹɛf
dɹɔnssuɹt	dɹɔnstʊɹt
dɹegsæp	tɹegsap
pɸiɹnnɹɔf	pfiɹnnɹɔf
ziɹbbɹæɹ	dɪɹbbɹaɹ
agnɛs	agnɛs
bɹofɸif	bɹofpif
dɹoɹbkæt	dɹoɹpkad
lɹiɹbsnip	lɹɪɹbsnip
ɸoxɛɹp	pokɛɹb
lɹiɹgɢɔf	lɹiɹkgɔf
ɸiɹbzo	piɹbdo
bɹɔllɔns	pɹɔllɔns
dɹæzuɹt	dɹadʊɹd
næstpɸi	nastpfi
pɸiɹnɹɛs	pfiɹnɹɛs
xɛɹbniɹp	kɛɹpnɪɹb
uɹfsof	uɹftof
tseɹbɹeɹp	tseɹpɹeɹp
bɹusfuɹp	bɹusfʊɹb
bɹɔtdɹa	bɹɔtdɹa
pɸædɹɛn	pfatɹɛn
lɹoɹnæɹp	lɹoɹnaɹp
sætlɹɛt	satlɹɛt
noɹfβøs	noɹfbes
gɹoɹdnins	kɹoɹdnins
ɸoɹgɢɔɹ	poɹkgɔɹ
ɣeɹdɹuɹ	geɹdɹʊɹ
nɹiɹmɸut	nɹɪɹnpʊd
bɹælpɸæɹp	bɹalpfaɹp
βøɹgbɹuf	beɹkbɹuf
ɸibfɹuɹs	pibfɹuɹs
pɸiɹbsnæfp	pfiɹbsnafp
sɹiltæf	sɹɪltaf
dɹæɹlzuɹp	dɹaɹlduɹp
nɹeɹgfuɹt	nɹeɹkfʊɹd
pɸoɹdbɹæfp	pfoɹtbɹafp
nɹilβuɹp	nɹɪlbuɹb
siɹbnɹeɹn	tɪɹpnɹeɹn
sɹindɹiɹk	sɹɪndɹiɹk
zifen	dɪfen
iɹdsɹɔs	ɪɹtsɹɔs
fɔfsuɹk	fɔfsuɹk
ɹɛɹlβit	ɹɛɹlbid
sɛɹgsɹuk	tɛɹgsɹʊk
pɸæɹdɹɛst	pfaɹtɹɛst
gɹiɹbsniɹl	gɹiɹbsnɪɹl
lɹæpnɹot	lɹapnɹot
dæfpɸiɹk	dafppiɹk
sɹɔɹbsup	sɹɔɹpsʊp
lutzɛl	lutdɛl
siɹgdɹins	siɹgtɹɪns
bɹɛdɹufp	pɹɛdɹufp
bɹɔbɸɶfp	pɹɔbpafp
ɸœdɹiɹp	pɛtɹɪɹb
fɹistfæf	fɹɪstfaf
gɹæɣest	gɹagest
fepsiɹt	fepsiɹd
sofpdæt	sofpdat
dɹobfɔɹk	tɹobfɔɹg
pɸuɹɹuɹt	pfʊɹɹuɹt
ɹistlɹiɹn	ɹɪstlɹɪɹn
lɹiɹlɹeɹt	lɹiɹlɹeɹd
dɹeblɹeɹt	tɹeblɹeɹd
uɹmbɹik	ʊɹnpɹɪg
dɹitgɹot	dɹitgɹod
βømɸœt	benpɛd
seɹlbɹen	seɹlpɹen
fæstsɹæs	fastsɹas
fosttsɛs	fosttsɛs
nɹɔdnɹefp	nɹɔdnɹefp
βoɹgɸoɹl	boɹkpoɹl
sænsɹæp	sansɹap
xɛfpsɹoɹs	kɛfpsɹoɹs
sniɹɱfɹɛɹn	sniɹnfɹɛɹn
dɹɛɹspɸuns	dɹɛɹspfʊns
gɹoɹslɹɛn	kɹoɹslɹɛn
dɹɛniɹk	tɹɛniɹk
bɹɛɹmɸoɹp	bɹɛɹnpoɹp
tæɹgsɛɹn	taɹksɛɹn
snæfbɹɔ	snafpɹɔ
lɹiɹdsɹɔl	lɹiɹdsɹɔl
bɹuɹbsnit	pɹuɹbsnid
nɹiɹgsifp	nɹɪɹgsɪfp
sɛsdɹi	sɛstɹɪ
ɢudgɹof	gudkɹof
xɛɹggɹɔɹk	kɛɹggɹɔɹg
bɹeblɹɛfp	bɹeblɹɛfp
fædɹɛk	fatɹɛg
sɹuɹŋɣɛɹp	sɹuɹngɛɹb
ɢubquɹs	gʊbkuɹs
pɸugfɹoɹt	pfugfɹoɹt
suɹnɔns	tʊɹnɔns
ostsɹæk	ostsɹak
sɹotnɹɔp	sɹotnɹɔb
dɹeŋɢɔk	tɹengɔk
nɹɛɹlfɹons	nɹɛɹlfɹons
gɹeɹlfɹek	gɹeɹlfɹek
byɸøk	bɪpeg
snidbɹet	snɪdpɹed
sɹiɹbgɹifp	sɹɪɹbgɹɪfp
βœnsfe	bɛnsfe
pɸofdæn	pfofdan
fɹæɹflɹik	fɹaɹflɹik
niɹbɣiɹt	niɹpgiɹt
dɹiɹgdɹɔɹn	tɹiɹgdɹɔɹn
xilsniɹf	kɪlsnɪɹf
dɹofgɹuɹk	tɹofgɹuɹk
dɹulsɹep	tɹʊlsɹep
fɛdsip	fɛdtɪb
dɹoptseɹ	tɹoptseɹ
suknuɹn	tʊknʊɹn
βœɹdzeɹ	bɛɹtdeɹ
dɹupsɹɔɹk	tɹupsɹɔɹk
ɸœɹfnins	pɛɹfnɪns
βɔdtæɹk	bɔdtaɹk
iɹŋquɹs	iɹnkʊɹs
nɹeɹstsuɹp	nɹeɹstsʊɹb
dɹɛɹgsuɹt	dɹɛɹgtuɹd
βødlɛs	bedlɛs
nɔquɹn	nɔkuɹn
lɹuɹssefp	lɹʊɹstefp
zɔɹdsiɹp	dɔɹdsiɹp
snuɹgsɔɹs	snuɹktɔɹs
dɹɔɹfɔɹf	tɹɔɹfɔɹf
snɛfdɹil	snɛfdɹil
nutnɹɛn	nʊtnɹɛn
nugfeɹn	nʊgfeɹn
dɹædsit	tɹadtɪt
dɹæɹgquɹ	dɹaɹkkʊɹ
pɸusɢon	pfʊsgon
zostgɹɛt	dostkɹɛt
dɹunskæt	tɹunskad
tsuɹŋxɛp	tsuɹnkɛb
bɹoɹfbɹæɹk	pɹoɹfpɹaɹg
xiloɹn	kiloɹn
snɔɹsgɹun	snɔɹsgɹun
tsiɹbgɹen	tsiɹpkɹen
tsensdɹiɹl	tsensdɹiɹl
sɹeɹblɹun	sɹeɹplɹun
bɹiɹdfɹuɹn	bɹiɹdfɹuɹn
ɹupgɹist	ɹupgɹist
βoɹdgɹul	boɹtgɹul
soɹfsɹeɹn	soɹfsɹeɹn
snutlæns	snutlans
funsbɹiɹn	funspɹiɹn
lɹibnɹifp	lɹibnɹifp
sɔɹβik	tɔɹbik
nɹoɹbfup	nɹoɹpfʊp
fɹuɹbgɹɛɹ	fɹʊɹpgɹɛɹ
sɹidsofp	sɹidsofp
sɛdnɹuɹs	sɛdnɹuɹs
gɹuɹzuɹp	kɹʊɹduɹp
lɹɛɹlbɹuɹl	lɹɛɹlbɹʊɹl
ɹuɹdβifp	ɹuɹtbifp
bɹɔɹfgɹif	bɹɔɹfkɹɪf
fiɹgbɹit	fɪɹkpɹid
bɹɛɹblæt	pɹɛɹplad
gɹɛtsiɹn	gɹɛtsiɹn
bɹuɹbyk	bɹuɹpɪg
ɢɔɹdβɶt	gɔɹdbat
dɹɛlsɹɔl	tɹɛlsɹɔl
sumɸɶs	sʊnpas
ɸinsβɔɹl	pinsbɔɹl
sutbɹæɹp	tʊtpɹaɹp
nɹuɹdfɹu	nɹuɹdfɹu
pɸoɹdnek	pfoɹtneg
pɸɛstfɹæk	pfɛstfɹak
zuɹfsnil	duɹfsnil
zostlɹufp	dostlɹʊfp
iɹniɹf	iɹnɪɹf
kæpɸøt	kapped
dɹuɹgsnuɹs	dɹuɹksnuɹs
lɹolɹuɹt	lɹolɹuɹd
dɹækfɹok	tɹakfɹog
gɹæɹgbɹuɹl	gɹaɹkbɹʊɹl
snefpbɹuk	snefppɹug
ospɸæs	ospfas
ɹutæp	ɹʊtap
fælsɛns	faltɛns
ɸɔtpɸist	pɔtpfɪst
fɹuɹnsik	fɹuɹntɪk
gɹɛdnɹæp	kɹɛdnɹap
lɹiɹŋɣeɹp	lɹɪɹngeɹp
tsoɹlɹifp	tsoɹlɹifp
sɹibɢuɹk	sɹɪbgʊɹg
sɛtbɹist	sɛtbɹɪst
nontsif	nontsif
iɹblɹɔfp	iɹplɹɔfp
ɢɔɹdnɛɹ	gɔɹdnɛɹ
kæɹgnɹuk	kaɹknɹʊg
zɛptæt	dɛptad
βussɛp	bʊstɛp
ɹinstsuɹf	ɹɪnstsʊɹf
ɹoɹdbɹæl	ɹoɹdpɹal
ɹupbyɹp	ɹupbɪɹb
βisdɹuɹn	bistɹuɹn
bɹoɹnsut	pɹoɹnsʊd
bɹoɹsgɹon	bɹoɹskɹon
nɹɔstzuɹl	nɹɔstduɹl
lugtsis	lʊgtsɪs
ɸɔpnɹɛfp	pɔpnɹɛfp
feɹffit	feɹffid
tsopsɹɛns	tsopsɹɛns
nigɹoɹ	nikɹoɹ
gɹænslɛp	kɹanslɛp
fɔsnɹut	fɔsnɹʊd
ɸœɹsxɛp	pɛɹskɛb
sɔbsnuɹt	sɔbsnuɹd
fɹonssɹon	fɹonssɹon
fitɸøɹs	fɪtpeɹs
siplɛɹf	tɪplɛɹf
nɹæɹfɸɶp	nɹaɹfpab
lɹiɹldɹuɹf	lɹɪɹltɹuɹf
lɹipɸuɹt	lɹɪpfʊɹt
sɔɹlɣɛɹt	sɔɹlgɛɹt
gɹuɹlɹiɹt	gɹuɹlɹɪɹt
tsitsa	tsitsa
ɸøsttseɹl	pesttseɹl
pɸubtsuɹk	pfʊbtsʊɹg
sɹɔdlɹɛɹk	sɹɔdlɹɛɹg
gɹæffɛɹ	gɹaffɛɹ
nɛfɸɔk	nɛfpɔk
ɸɶɹzes	paɹdes
ɸøɹggæɹs	peɹggaɹs
nɹɔɹsβøɹt	nɹɔɹsbeɹt
snɛbɹɔɹn	snɛbɹɔɹn
qulpɸɔl	kulpfɔl
fussnek	fʊssneg
fɹɔɹbfɹik	fɹɔɹbfɹɪk
pɸenlɹufp	pfenlɹufp
pɸæɹdɸɶp	pfaɹtpab
βɶɹfliɹp	baɹfliɹp
ɸopbɹup	poppɹʊp
ɹuɹnnuɹp	ɹuɹnnuɹp
lɹoɹgsnuɹl	lɹoɹgsnʊɹl
bɹistlɹifp	bɹistlɹifp
nɹobβuɹ	nɹobbuɹ
dɹukdɹis	tɹukdɹɪs
βofpɸiɹp	bofpfɪɹp
βɶbpɸep	babpfeb
gɹeɹŋgɹɛɹ	gɹeɹnkɹɛɹ
dɹɛgdɹɔns	dɹɛgdɹɔns
sɹæddɹet	sɹaddɹet
dɹuɹɹɛs	tɹuɹɹɛs
ɸupbɹɔn	pupbɹɔn
unɔs	ʊnɔs
udɹof	ʊdɹof
lɛɹgtsos	lɛɹgtsos
tsuɹlef	tsʊɹlef
ɔɹgkæɹk	ɔɹgkaɹk
foŋgɹik	fonkɹik
sutbɹuɹn	sutpɹʊɹn
fɹɛtβuɹn	fɹɛtbʊɹn
snɛɹβit	snɛɹpid
sugdɹɔf	tʊgdɹɔf
xifnuk	kifnuk
pɸæsttsop	pfasttsop
gɹuɹbβœp	kɹuɹbbɛb
ɹembɹik	ɹenbɹɪk
nuɹdβust	nuɹtbust
bynssuk	bɪnstʊg
fɹuɹdziɹn	fɹuɹddiɹn
tsoɹlβuɹl	tsoɹlbʊɹl
gɹiɹdnæf	kɹɪɹdnaf
dɹæɣɛɹs	tɹagɛɹs
ɹutlif	ɹʊtlɪf
dɹutɣiɹk	dɹutgiɹk
βiɹbsnuɹp	biɹbsnuɹp
sɔɹlnɹu	tɔɹlnɹʊ
bɹuɹfnit	pɹuɹfnɪt
pyɹsdɹus	pɪɹsdɹʊs
gɹæɹdgɹɔn	gɹaɹdkɹɔn
snɛnssnons	snɛnssnons
ɸiɹmbɹip	piɹnpɹip
sidtsek	sidtsek
bɹuɹssɹut	pɹʊɹssɹut
snɔsniɹp	snɔsniɹb
dɹidɣiɹf	dɹidgɪɹf
bɹæɹiɹ	pɹaɹiɹ
dɹuldɹifp	tɹʊldɹifp
gɹæfpgɹoɹk	kɹafpkɹoɹk
suɹlɢɔɹf	suɹlgɔɹf
dɹɛknɹeɹ	dɹɛknɹeɹ
nidpɸi	nɪdpfi
ɣeɣeɹn	gegeɹn
ɔgbɹi	ɔgpɹi
lɹustlɹɔɹn	lɹʊstlɹɔɹn
tsoɹdlok	tsoɹdlog
zipnɹoɹ	dipnɹoɹ
gɹiɹsdɹæɹn	gɹiɹsdɹaɹn
dɹedsnup	tɹedsnʊp
nipsnun	nɪpsnʊn
snɔbbɹɔp	snɔbpɹɔb
ɸɶɹgdɹɛt	paɹktɹɛd
bɹɔsfep	bɹɔsfeb
fɹugnun	fɹʊgnun
fælgɹut	falgɹut
ɸøflot	peflot
bɹubnɹæp	pɹʊbnɹab
tsuɹssɹɔst	tsuɹssɹɔst
sɹæɱfin	sɹanfin
lɹudfit	lɹʊdfɪt
sɹibfɹol	sɹibfɹol
sinszust	sinsdʊst
gɹɔɹlpɸɛp	gɹɔɹlpfɛp
bɹodβifp	bɹodbifp
gɹudsniɹt	gɹʊdsniɹd
fɹubbɹi	fɹʊbbɹɪ
βoɹfgɹɛɹk	boɹfkɹɛɹg
dɹɔpsɔɹl	tɹɔpsɔɹl
nɹufnɹa	nɹufnɹa
dɹiɹbtsuk	tɹɪɹptsʊg
xisxɛfp	kɪskɛfp
fɛɹgfɛp	fɛɹgfɛp
snoɹlsnist	snoɹlsnist
dɹɛɹntæɹk	tɹɛɹntaɹg
lupdɹɛɹn	lupdɹɛɹn
bɹuɹŋgɹɔns	pɹuɹngɹɔns
bɹɛfplɹiɹk	bɹɛfplɹɪɹg
βøggɹoɹ	beggɹoɹ
ɢuɹdgɹins	gʊɹdkɹɪns
soɹɢuɹs	toɹkuɹs
akfuɹt	akfuɹt
βiɹbɹiɹt	biɹbɹiɹt
dɹudsi	dɹʊdtɪ
bɹikpɸɛɹp	pɹikpfɛɹp
lɹeɹlnuɹn	lɹeɹlnuɹn
nɹoɹnnoɹp	nɹoɹnnoɹp
nɹeɹdbɹæɹn	nɹeɹdbɹaɹn
fæstsol	fastsol
sneɹfɹɛn	sneɹfɹɛn
ɹɔliɹl	ɹɔliɹl
nɹuliɹp	nɹʊlɪɹp
dɹinssoɹk	tɹinssoɹg
gɹeɹdfɹæk	gɹeɹdfɹag
dɹuklɔns	tɹuklɔns
βøsnæs	besnas
ɸuŋgɹɔs	pungɹɔs
nɹufɹuɹk	nɹʊfɹʊɹg
ɸoɹntsens	poɹntsens
liɹbsnoɹp	liɹpsnoɹb
fotpɸuɹt	fotpfuɹd
dɹetɢok	dɹetgog
quɹgsnæɹp	kʊɹgsnaɹp
ɹɔɹspyf	ɹɔɹspɪf
dɹotβɔf	tɹotbɔf
ɹufɸøk	ɹufpeg
siɹdɢuɹp	siɹtgʊɹb
ɹopsu	ɹopsʊ
bɹuɹsbɹodtæp	pɹuɹspɹodtab
zuɹgqufnes	dʊɹgkʊfnes
ɹufɸøɹlbɹuɹt	ɹʊfpeɹlbɹʊɹd
dɹæɹgɸuɹɣin	dɹaɹgpʊɹgɪn
ɹuɹlgæmɸɶɹt	ɹuɹlganpaɹt
tsɛgdɹudβœ	tsɛgdɹʊdbɛ
ubdɹupɢup	ubdɹʊpgub
gɹinsebɸuns	gɹinsebpʊns
sɹustzefptsiɹp	sɹʊstdefptsɪɹb
nigβɶdsɹiɹf	nigbadsɹɪɹf
gɹæɹddɹistdɹɔf	kɹaɹtdɹɪstdɹɔf
næɹdfɹofdæk	naɹdfɹofdag
gɹuftsuddæɹt	gɹʊftsuddaɹd
sɹɛbgɹegsnuɹt	sɹɛbgɹegsnuɹd
niɹdɸinsuɹt	nɪɹdpintuɹd
sɹænsliɹnsɹæl	sɹansliɹnsɹal
ɢugfɹæfɸɶk	gugfɹafpag
lɹebsnɛstsnop	lɹebsnɛstsnop
liɹlɹɛɹgnɹæns	lɪɹlɹɛɹgnɹans
nɹɛɹdɢɔɸøɹp	nɹɛɹdgɔpeɹp
qufpsnefpβɔɹp	kufpsnefpbɔɹp
bɹidsɹoɹlsip	pɹidsɹoɹltɪb
sɹɔɹβøɹsleɹk	sɹɔɹpeɹsleɹg
nænssniɹβøst	nanssnɪɹbest
dɹebɹiɹdbɹiɹ	tɹepɹiɹdpɹɪɹ
dæɹssɹuɹfɹɛp	daɹssɹʊɹfɹɛp
fɔzɔdsɹip	fɔdɔdsɹib
fɹiɹmβøtpɸɛp	fɹiɹnbetpfɛp
lɹuɹdlɹæɹlfæɹl	lɹuɹdlɹaɹlfaɹl
siɹbnɹæstdɹeɹp	sɪɹbnɹasttɹeɹp
ɔfbɹælsit	ɔfpɹaltɪt
gɹægɹifplɹæp	kɹakɹifplɹap
lomβɔgpɸons	lonbɔgpfons
gɹuɹlzɔɹdtsɔɹn	kɹuɹldɔɹdtsɔɹn
xɛɹspyɹdnɹæɹp	kɛɹspɪɹdnɹaɹb
sɹuɹbnɹækfɔp	sɹuɹpnɹakfɔb
gɹæɹlgɹipβuɹp	kɹaɹlkɹɪpbʊɹp
tsefpbybsɹuɹk	tsefpbɪbsɹuɹk
zɛgɹuɹbbɹiɹp	dɛgɹuɹbbɹiɹp
ɸɶsɹilæt	pasɹilad
nɹoɸɔɹdfæɹp	nɹopɔɹtfaɹp
sɔɹgpɸuɹdfɹek	sɔɹgpfuɹdfɹeg
snusɸøɹfbys	snuspeɹfbɪs
snuɹfdɹɔɹdɹiɹt	snuɹfdɹɔɹdɹɪɹd
zugdɹæɹlxip	dugtɹaɹlkɪp
nɹegsɹonsdɹo	nɹegsɹonstɹo
siɹbbɹɔgsnul	siɹbbɹɔgsnʊl
dɹispɸufpβɶp	dɹispfʊfpbab
ɢuɹgæɹdsefp	gʊɹgaɹdtefp
fekpɸikɢust	fekpfɪkgust
snɛɹddæpdɹɛɹ	snɛɹtdapdɹɛɹ
setgɹæɹbnɔɹf	setgɹaɹpnɔɹf
dɹupgɹæksneɹk	tɹʊpkɹaksneɹk
ɸuɹdfɹiɹlgɹa	pʊɹdfɹiɹlgɹa
zuɹfβiɹsɹɛs	duɹfbiɹsɹɛs
dɹofnobdɹeɹf	dɹofnobdɹeɹf
sɛɹbfɹeɹdtsæk	sɛɹbfɹeɹdtsag
byknɹeddɹiɹs	bɪknɹeddɹiɹs
nɹæklɹæɹgsɹæfp	nɹaklɹaɹksɹafp
snuɹbnɔsit	snuɹbnɔtit
fuggɹɔɹltsuɹl	fʊgkɹɔɹltsʊɹl
ɹeɹsuɹbnɹɔɹt	ɹeɹsʊɹpnɹɔɹd
gɹuɹsgɹofplɔɹp	gɹʊɹskɹofplɔɹp
nɹɛfsɹɔfsek	nɹɛfsɹɔfteg
iqɔlpɸoɹk	ikɔlpfoɹg
bɹugɹugɹufp	pɹugɹʊkɹufp
siɹgdɹænɔfp	tiɹgdɹanɔfp
fɹuɹnsɹɔdgɹup	fɹʊɹnsɹɔdkɹʊp
ɢuɹbdɹɛŋxɛɹp	guɹptɹɛnkɛɹb
ɔɹbnɹogtsep	ɔɹbnɹogtseb
βødɹizuns	bedɹɪdʊns
ɣeɹglupɸɹiɹt	geɹklʊpfɹiɹt
ɣiɹɣilgɹoɹk	giɹkilkɹoɹg
bɹeɹndɹugɹiɹk	bɹeɹntɹʊgɹɪɹk
snegdɹæɹgsen	snegtɹaɹgsen
ɹɔlbɹætsol	ɹɔlpɹatsol
dɹɛtɣiɸik	dɹɛtgipig
xiɹlɹæɹbzɛ	kɪɹlɹaɹpdɛ
nɹæsgɹufptsit	nɹaskɹufptsid
pɸæssiɹnɹiɹs	pfassiɹnɹiɹs
bɹinstæbza	pɹinstabda
ɛpsɹoszoɹs	ɛpsɹosdoɹs
aɹdɣɛsfit	aɹtgɛsfɪt
loɹdzoffun	loɹtdoffʊn
lænssɛɹbtæp	lanssɛɹptab
dɹosβuɹɣiɹp	dɹosbʊɹgiɹb
lɹɛgdɹudlɛl	lɹɛgdɹʊdlɛl
bɹuɹdbɹuɹzes	pɹuɹtbɹʊɹdes
liɹnlofpɸɹins	liɹnlofpfɹins
pɸɛdtæffɹik	pfɛdtaffɹig
siɹgzinsbɹuɹt	sɪɹkdɪnspɹʊɹt
ɔɹbkæstliɹf	ɔɹbkastliɹf
tsɔpbɹitɢut	tsɔppɹitgʊt
gɹeɹbnɛɹzist	gɹeɹpnɛɹdɪst
dɹeɹgtsæɹsdɹɛs	dɹeɹktsaɹstɹɛs
lɹæɹbbɹipdɹifp	lɹaɹbpɹɪpdɹɪfp
dɹiɹffɔggɹiɹt	tɹɪɹffɔgkɹɪɹt
supxeɹlfɹeɹf	supkeɹlfɹeɹf
dɹɔsɸøbsofp	dɹɔspebsofp
tsiplɛflɹeɹs	tsiplɛflɹeɹs
siɹbtsosɛt	sɪɹptsosɛd
xipsɹiɹblɹos	kipsɹɪɹblɹos
gɹuɸɔxɛns	kɹʊpɔkɛns
dɹɔɹlbɹiɹgsiɹp	dɹɔɹlbɹiɹgtiɹp
nɹeɹdβøsseɹs	nɹeɹdbesteɹs
bɹilosɹik	pɹɪlosɹɪg
sɹeɹdfikɣiɹn	sɹeɹtfikgɪɹn
nɹefpsosɸœɹn	nɹefpsospɛɹn
bynssuɹglɔɹ	bɪnssʊɹklɔɹ
nɛddɹɔsɛt	nɛdtɹɔtɛd
βuɹfβœbqoɹn	bʊɹfbɛbkoɹn
βœtɣidbɹiɹ	bɛtgɪdbɹiɹ
lɹoɹlɔɹgɹæɹn	lɹoɹlɔɹkɹaɹn
bɹæɹgnɹæɹɢok	bɹaɹgnɹaɹkok
fɹiŋqokβœɹp	fɹɪnkokbɛɹp
ɢugnɹinsxeɹf	gʊgnɹɪnskeɹf
dɹoɹdpɸɛɹntsiɹs	dɹoɹtpfɛɹntsiɹs
dɹogsnuɹbfɹɔf	dɹogsnʊɹbfɹɔf
fefpɢubsɛɹk	fefpgʊbtɛɹk
βoɹlxɛlβok	boɹlkɛlbok
xifnɹuɹslel	kifnɹuɹslel
gɹubbɹetfɹok	gɹubbɹetfɹog
ɸulgɹuɹdsɹɛɹt	pulgɹʊɹtsɹɛɹd
gɹifpɸɹiglɹen	gɹɪfpfɹɪglɹen
nɹeɹβogzik	nɹeɹbogdɪk
lɔfpsnɛɹdbɹæɹn	lɔfpsnɛɹdbɹaɹn
lɛɹblɔtzeɹt	lɛɹblɔtdeɹd
ɣensnɹɛdtsɔl	gensnɹɛdtsɔl
lɔplɔɹbsiɹ	lɔplɔɹbtiɹ
nɹɔfpsɹuŋɢu	nɹɔfpsɹungu
bɹuɹdgɹisɹɛt	bɹʊɹtkɹɪsɹɛd
lɹiɹgtsiɹdxɛɹl	lɹiɹktsiɹtkɛɹl
dɹefɣedfɛt	tɹefgedfɛt
neɹnsuklot	neɹntuklot
sɔpɸuksnuɹt	sɔpfuksnuɹd
sɹuɹgfinsgɹæf	sɹʊɹgfɪnskɹaf
fɹuɹglefnɹɔɹf	fɹʊɹklefnɹɔɹf
nɹusfɹisxek	nɹusfɹɪskek
bɹɛnufβœfp	bɹɛnʊfbɛfp
fæɹbsɛɹbqoɹk	faɹbtɛɹbkoɹk
sifpgɹissut	tɪfpkɹistud
fiɹsβœɹfbɹiɹf	fɪɹsbɛɹfbɹiɹf
bɹɛɹlɣiβot	pɹɛɹlgɪbot
kæɹssilnɹip	kaɹssilnɹɪb
bɹiɹbdɹænssnɛn	bɹiɹbtɹanssnɛn
noɹssɔɹdbɹup	noɹstɔɹdpɹʊp
dɹuɹdsnufgɹɔɹ	dɹuɹtsnʊfkɹɔɹ
ɹuɹsdɹoɹfgɹoɹs	ɹʊɹstɹoɹfgɹoɹs
pɸuɹgbɹiɹblɹof	pfʊɹkbɹɪɹplɹof
ɸœɹsfɹiɹbgɹok	pɛɹsfɹiɹbkɹok
sɛɹbxiɹsdɹul	sɛɹpkɪɹstɹʊl
tsikdædquɹs	tsikdadkʊɹs
βɶpɣɛɹbɹɛp	bapgɛɹbɹɛb
βiɹsdɹuɹdɹifp	biɹsdɹʊɹtɹɪfp
tsɛɹgdɹɛklɹæɹp	tsɛɹgdɹɛklɹaɹb
sulgɹibbɹeɹt	tʊlgɹibpɹeɹt
fuɹsuɹfnɔt	fʊɹsʊɹfnɔt
βiddɹuɹdsɔp	biddɹuɹtsɔb
fɹɔffɹuɹŋgɹɔst	fɹɔffɹʊɹngɹɔst
lɹæbsnoɹntsæt	lɹabsnoɹntsad
tædsɹɔlsuns	tadsɹɔlsuns
nɹefpseɹsbyɹk	nɹefpseɹsbɪɹg
βoɹfsɹuɹstsoɹs	boɹfsɹʊɹstsoɹs
bɹɛstsufbɹiɹf	bɹɛsttʊfpɹiɹf
sɹɛnslolsɹuɹk	sɹɛnslolsɹʊɹg
kæɹdsænsdɹip	kaɹtsansdɹip
fɹæsnufpsɹufp	fɹasnufpsɹufp
bɹɛɹlɢugɹɛɹk	bɹɛɹlgugɹɛɹg
læɹbɣiɹzeɹn	laɹpgɪɹteɹn
ludgɹæfɸu	lʊdgɹafpʊ
lɹiɹbdɹɔsttæɹk	lɹɪɹptɹɔsttaɹk
nɹeɹbnikβœk	nɹeɹbnɪkbɛg
feɹgɹɔɹβos	feɹkɹɔɹpos
sɹɔpsnitɣil	sɹɔpsnɪtgil
snuɹfsitdɹuɹt	snʊɹftittɹʊɹd
ɹeɹlɹɛgzen	ɹeɹlɹɛgden
sompɸiɹgdɹɛns	sonpfɪɹkdɹɛns
ɢɔɹnzoɹbbɹɛɹp	gɔɹndoɹpbɹɛɹb
lɹæɹbbɹɔfbɹek	lɹaɹpbɹɔfbɹek
ulpɸiɹgquɹt	ulpfɪɹgkuɹt
gɹunæɹnsɔɹf	gɹʊnaɹntɔɹf
fikdɹeɹslɹɛɹn	fiktɹeɹslɹɛɹn
sændɹestnɹik	sandɹestnɹɪg
fɹɛdnupyɹf	fɹɛdnʊpɪɹf
dɹɛstsɹɛɹdbɹon	dɹɛstsɹɛɹdpɹon
bɹubbykɣist	pɹubbɪkgɪst
fɹɛtgɹonsut	fɹɛtgɹonsʊt
fæɹzɛfpɸɹut	faɹdɛfpfɹʊt
siɹnɹiɹbɹuɹt	tɪɹnɹɪɹpɹuɹt
soffɹɔfpyns	soffɹɔfpɪns
dɹoddɹɛstbɹis	dɹoddɹɛstbɹis
sopnuɹnzɔk	sopnuɹndɔg
ɹogɢuɹfxin	ɹogguɹfkin
nækβustlɹon	nakbʊstlɹon
sɔgɹoɹlβɶɹt	sɔgɹoɹlbaɹt
bɹɛfsɔstbɹot	pɹɛftɔstbɹot
pɸensgɹonsɢuk	pfenskɹonsgʊg
finliɹlɹok	finlɪɹlɹog
gɹisfɹeɹsfufp	gɹɪsfɹeɹsfʊfp
næfpbɹuɹlbyk	nafppɹʊɹlbɪg
xifpnɹɛɹflɹiɹp	kifpnɹɛɹflɹiɹp
dɹuɹbsnostfɹɛɹt	tɹʊɹbsnostfɹɛɹd
bɹoɹlbɹuttsul	pɹoɹlpɹuttsul
ziɹsbɹæɹslɹup	dɪɹsbɹaɹslɹub
snuɹbbɹuglæs	snʊɹppɹuglas
letbyfpgɹoɹ	letbɪfpkɹoɹ
dɹiɹgbɹuɹgqɔp	dɹiɹgpɹʊɹkkɔb
xisbyslɔp	kɪsbɪslɔb
sniklɛdquɹ	snɪklɛdkʊɹ
gɹɔstdɹeɹbβœn	gɹɔstdɹeɹbbɛn
xɛpxefsnuɹ	kɛpkefsnʊɹ
pɸestfɹupxɛ	pfestfɹupkɛ
lɹifβɶɹgxifp	lɹɪfbaɹkkifp
tsiglegɹɔɹp	tsɪglegɹɔɹb
dɹunsiblus	tɹunsɪblʊs
sɹoksɛlβiɹn	sɹoktɛlbiɹn
ɹobsnuɹdsnuk	ɹobsnʊɹtsnug
gɹulsneɹmpɸil	kɹulsneɹnpfil
nɔɹssɹæstsins	nɔɹssɹasttins
qɔɹbkæɹbsɹɔɹt	kɔɹpkaɹbsɹɔɹt
fɔɹdnɹuɹnɹuns	fɔɹtnɹuɹnɹuns
dɹiɹndɹɔɹndɹɛn	tɹɪɹndɹɔɹntɹɛn
nopɸɹiplit	nopfɹiplɪt
dɹɔɹgdɹɔɹgfɹoɹl	tɹɔɹgdɹɔɹkfɹoɹl
fɹiɹzeɹlpɸo	fɹiɹdeɹlpfo
nɹostzɔɹβœt	nɹostdɔɹpɛt
lɔdqoffɹuɹs	lɔdkoffɹuɹs
qoɹdlɔstnɹoɹk	koɹdlɔstnɹoɹk
fɹusɢoɹbɹɛfp	fɹʊsgoɹbɹɛfp
fuɹdbɹɔpnoɹt	fuɹtpɹɔpnoɹt
snɛɹddɹɛɹbbɹons	snɛɹddɹɛɹppɹons
supquɹdnifp	sʊpkʊɹdnifp
bɹitæɹbquf	bɹitaɹbkuf
nɹiɹdɹiɹspɸæt	nɹɪɹdɹiɹspfad
nɹinsgɹɔkɣiɹs	nɹɪnskɹɔkgiɹs
lilgɹɛkzons	lilgɹɛkdons
lɹiɹfɹunæɹt	lɹiɹfɹunaɹt
bɹænsfɛɹbβœɹn	bɹansfɛɹbbɛɹn
dɹistdɹiknɹɛɹt	dɹɪsttɹɪknɹɛɹt
dɹiɹbβiɹspɸɛt	dɹiɹpbiɹspfɛd
oɹbtsɔnnæp	oɹptsɔnnab
bɹuɹbfugnɹɛɹl	bɹʊɹpfugnɹɛɹl
bɹufpbɹæpɸoɹt	pɹʊfppɹapfoɹd
fɛsusdɹæp	fɛsʊstɹab
nɹæbsɹustgɹu	nɹabsɹustgɹu
gɹukdɹɔɹfdɹæn	gɹuktɹɔɹftɹan
gɹuɹbsninsnɛt	gɹʊɹbsninsnɛt
nuɹgsɹoɹfpɸof	nʊɹgsɹoɹfpfof
gɹoɹbfɹenssɛp	gɹoɹpfɹenssɛb
eɹbseɹgsiɹt	eɹbteɹgsɪɹd
nindɹɛnsbɹiɹp	nɪndɹɛnspɹɪɹp
ɸøɹbpɸuɹbtsuf	peɹppfuɹbtsʊf
dɹiɹbβutsoɹp	dɹɪɹpbʊtsoɹb
bɹuɹgnɛɹbgɹɛfp	pɹuɹgnɛɹbgɹɛfp
nɹitɢoɹŋɢuf	nɹitgoɹnguf
snissnɛɹspɸin	snɪssnɛɹspfɪn
tsifzusxik	tsifduskɪk
siɹffɹælbɹens	tiɹffɹalpɹens
xeŋɢonsɹins	kengonsɹins
dɹopsɹæsgɹeɹp	tɹopsɹaskɹeɹp
bɹoɸusfæs	bɹopʊsfas
tsogfuntsɛst	tsogfʊntsɛst
sɛɹsɣisnɹi	sɛɹsgɪsnɹɪ
snɔɹbɣedsɹɛɹk	snɔɹbgedsɹɛɹg
ɹuɹfsɹoɹftsuɹp	ɹuɹfsɹoɹftsʊɹp
bɹæɹblɹuɱfɹɔɹp	pɹaɹplɹunfɹɔɹb
siɹbtsɛɹbɹuf	tɪɹbtsɛɹpɹʊf
ɢuɹnɹistæp	guɹnɹistab
gɹællɔtgɹɔɹs	gɹallɔtgɹɔɹs
lɹelnænsgɹes	lɹelnansgɹes
nɹɛfpsnɔgsnek	nɹɛfpsnɔgsneg
βibβofbɹuɹk	bibbofbɹuɹk
byɹgfɛɹsgɹu	bɪɹkfɛɹskɹʊ
ɢufnɹiblit	gufnɹiblɪt
gɹætsuɹlsɹofp	gɹatsʊɹlsɹofp
snɔquŋgɹefp	snɔkungɹefp
sneɹlæziɹp	sneɹladɪɹb
neɹffɹætfɹɔt	neɹffɹatfɹɔd
sæstsefne	sasttefne
lɹiɹsgɹibtsɛp	lɹiɹskɹibtsɛb
sæddɹeɹdβuɹk	saddɹeɹdbuɹk
ɢɔpɸɛdfɹɔɹt	gɔpfɛdfɹɔɹd
bɹusgɹoɹbβuns	pɹʊsgɹoɹbbʊns
nɹɔɹbβustbɹɔp	nɹɔɹbbʊstpɹɔb
fɹiɹlɹistdɹæk	fɹiɹlɹistdɹak
fɹɔgfɹustdɹet	fɹɔgfɹʊstdɹed
zɛfpdɹudqɔp	dɛfptɹʊdkɔp
gɹiɹdgɹufbɹet	kɹɪɹtgɹufpɹed
lɹuɹfiɹdɸik	lɹuɹfiɹtpik
dɹæbɸøpdɹoɹn	tɹabpepdɹoɹn
ɹɛgdɹuɹzo	ɹɛgdɹuɹto
luɹbdɹibdɹɛl	lʊɹbtɹibtɹɛl
seɹdsɔɹgqo	teɹtsɔɹkko
ɸuɹfɸuɹgbɹɔɹs	puɹfpuɹkpɹɔɹs
βiɹbfɹentsoɹp	biɹbfɹentsoɹb
aɹflɛɹsdɹuɹk	aɹflɛɹsdɹuɹk
zuɹbfɹɔsfɛt	duɹpfɹɔsfɛd
sofpβɶflɹɛp	sofpbaflɹɛp
zupnɛbɹɛɹk	dʊpnɛpɹɛɹk
fɹoɹblækzɔns	fɹoɹplakdɔns
lulsusttsɔɹf	lultʊsttsɔɹf
lɛɹgfufpxɛɹl	lɛɹgfʊfpkɛɹl
zofɛɹluɹk	dofɛɹluɹg
zɛssɹostzɛfp	dɛssɹostdɛfp
gɹuɹfqubsnɔɹn	kɹʊɹfkubsnɔɹn
zoslɹuɹbfɹɔɹl	doslɹuɹbfɹɔɹl
bɹompɸulson	pɹonpfulton
zɛsgɹufpyn	dɛsgɹʊfpɪn
gɹidnɹifos	gɹidnɹifos
fɹunsɛɹβuɹk	fɹʊnsɛɹbuɹg
fɹussuɹbgɹuɹf	fɹussʊɹbgɹʊɹf
bɹɔŋgɹuɹlpyɹt	bɹɔngɹuɹlpɪɹd
liɹbnɹuɹfɹæns	liɹbnɹuɹfɹans
dɹisgɹɔnsik	dɹɪsgɹɔntɪg
pɸiɹblæfptsut	pfiɹblafptsud
gɹuɹsfɹæstβut	gɹʊɹsfɹastbʊd
ɛɹlxekkæɹp	ɛɹlkekkaɹp
dɹɛkɸɔstbɹiɹ	tɹɛkpɔstpɹɪɹ
sæɹlsepsɛt	saɹlteptɛd
sɹɛɹslɹuɹsdɹik	sɹɛɹslɹʊɹstɹik
zegsɹɔtdɹoɹp	degsɹɔttɹoɹp
pɸɛɹzulsu	pfɛɹdultʊ
ɢɔɹgɹessnæt	gɔɹgɹessnad
dɹunsɹɔkfun	dɹunsɹɔkfun
nuggɹæflɹæɹn	nʊgkɹaflɹaɹn
bɹiɹdfoɹbgɹiɹn	bɹɪɹdfoɹbkɹiɹn
liɹbfɹæɹfbɹik	lɪɹbfɹaɹfbɹik
nɹeksibset	nɹeksibted
lɹinsdɹifpɸɛk	lɹɪnstɹifpfɛg
dɹæɹbnɹisbɹons	tɹaɹpnɹisbɹons
βufpɸotsɔɹn	bʊfpfotsɔɹn
nɹuɹnsɔɹdgɹiɹ	nɹuɹntɔɹdkɹiɹ
feblɹoɹbliɹk	feblɹoɹpliɹk
nɛɹdlɹisgɹɔf	nɛɹdlɹɪskɹɔf
pɸeɹblɔɹzuɹl	pfeɹblɔɹtuɹl
sɹibbɹubbɹek	sɹɪbbɹubpɹeg
nebsɔɹdɢuɹt	nebtɔɹdguɹd
ɸoslɹiɹgbɹins	poslɹiɹgbɹins
dɹinsɹɛɹdlif	tɹinsɹɛɹtlif
lænssɛɹndɹæl	lanstɛɹndɹal
sɹɛnsgɹuɹblæɹt	sɹɛnskɹʊɹplaɹt
ɣiɹdfesɹɔt	gɪɹdfesɹɔd
ɹiɹglɹɛɹnnuns	ɹɪɹglɹɛɹnnuns
gɹeɹnlɹiɹgbɹuɹn	kɹeɹnlɹɪɹgbɹuɹn
bɹɔɹbgɹɔɹbsɹiɹf	bɹɔɹbgɹɔɹbsɹɪɹf
gɹægɹɔɹssiɹn	gɹagɹɔɹstiɹn
bɹɛɹgpytsofp	bɹɛɹkpɪttofp
iɹfnɛɹsbɹeɹk	ɪɹfnɛɹspɹeɹg
fɹɛɹdnɹɔɹgnef	fɹɛɹtnɹɔɹgnef
sɹiɹɢuɹgɹet	sɹɪɹkʊɹgɹed
pɸeɹgniptsɛns	pfeɹknɪptsɛns
ɢofpɸɹiɹdbɹest	gofpfɹɪɹtpɹest
ɹefdɹɔfpβifp	ɹeftɹɔfpbifp
ɸɔpɸoɹbsus	pɔppoɹptʊs
lustsistæɹp	lʊstsistaɹb
ɹodfoɹlgɹit	ɹodfoɹlgɹɪd
suflufbɹæɹl	tuflufbɹaɹl
bɹeɹbfæɹlbɹɔɹs	bɹeɹpfaɹlpɹɔɹs
siɹsdɹeɹdɢut	siɹstɹeɹdgud
tsuɹβøpbɹik	tsuɹbepbɹig
sɔɹbɹeɹbbɹil	tɔɹpɹeɹpbɹɪl
dɹæɹlfiɹsdɹɔɹt	dɹaɹlfiɹstɹɔɹt
bɹiɹssuɹgsɹu	pɹiɹstuɹksɹʊ
fɹeɹdlɹeɹdɣeɹf	fɹeɹtlɹeɹtgeɹf
bɹuɹglɹidbɹoɹf	pɹuɹklɹidpɹoɹf
dɹufæɹgβop	tɹufaɹkbop
lustɸøɹgzut	lʊstpeɹkdud
fɹuɹbpɸuɹgɣeɹk	fɹʊɹppfʊɹggeɹk
suqukbɹik	tʊkukbɹik
bɹæpɸɶkquɹt	pɹappakkʊɹd
βuɹmbɹistgɹek	buɹnpɹistkɹek
fɹeɹdliɹlsɔɹk	fɹeɹtlɪɹltɔɹk
ɔfbɹoɹfsuɹf	ɔfpɹoɹftʊɹf
suɹdbɹæɹggɹiɹf	suɹtbɹaɹggɹɪɹf
ɸœɹssæffæɹl	pɛɹssaffaɹl
ɹuɹgβuɹgsnip	ɹʊɹkbuɹksnip
ɢɔɹgsnustæt	gɔɹgsnʊstad
ziɹbsnɔdsi	diɹpsnɔdsi
sɹænsɸøɹsgɹup	sɹanspeɹsgɹub
bɹozɛɹdβøɹk	bɹodɛɹdbeɹg
zofpdɹuɹdfæp	dofpdɹʊɹdfab
zuptsestzuns	duptsestdʊns
ɢɔtdɹɔklip	gɔtdɹɔklip
ɹitsniɹgdɹɔp	ɹitsniɹktɹɔp
ɹæɹdɢuɹdpɸɛf	ɹaɹtgʊɹtpfɛf
ɸiɹlbɹudsuɹl	piɹlpɹʊdsʊɹl
tsɔɹfdɹubtæk	tsɔɹfdɹʊbtag
snuɹbgɹinspɸuɹk	snuɹpgɹinspfʊɹg
gɹuɹbdɹundɹæɹn	kɹʊɹptɹundɹaɹn
gɹuɹsbɹunlɹiɹk	kɹʊɹspɹʊnlɹiɹk
ɸɔɹfɹinsbɹɔɹt	pɔɹfɹɪnsbɹɔɹd
zupɢɔɹfnɹɔp	dupgɔɹfnɹɔb
lɹoɹdnottsiɹp	lɹoɹdnottsiɹb
idtsɔɹbsoɹf	ɪdtsɔɹbtoɹf
bɹuɹgdɹeɹbdɹil	pɹuɹkdɹeɹptɹil
pɸɔɹɣɛlsnɔɹk	pfɔɹgɛlsnɔɹg
gɹoɹddɹipɸuɹt	gɹoɹttɹipfʊɹd
ɹænsiɹɹɔɹp	ɹansɪɹɹɔɹb
βøɹlgɹidzens	beɹlgɹiddens
lɹɔɹbfɛgsiɹf	lɹɔɹpfɛgtɪɹf
zuɹbtsuɹdɹik	dʊɹbtsuɹtɹig
fæɹflɹennɹoɹn	faɹflɹennɹoɹn
tsɔmβugpɸæns	tsɔnbʊgpfans
pɸeɹblɹoɹbfɹɔɹk	pfeɹblɹoɹpfɹɔɹk
dɹɛstdɹiɹbtsɔfp	dɹɛsttɹiɹptsɔfp
gɹɔɹdgɹiɹdfɹifp	gɹɔɹdgɹɪɹtfɹɪfp
dɹetɣeɹnzɔɹp	tɹetgeɹndɔɹb
pɸidfɛnɹɔɹf	pfɪdfɛnɹɔɹf
fiɹbdɹiɹsnoɹp	fɪɹbtɹɪɹsnoɹp
gɹoɹdgɹumbɹon	kɹoɹdgɹʊnbɹon
sɹifsɛnstsæɹ	sɹɪfsɛnstsaɹ
fiɹfɣedbɹeɹk	fɪɹfgedbɹeɹg
siɹntsuppɸuɹt	tɪɹntsʊppfʊɹt
sulpɸuɹgfɹæk	tulpfʊɹkfɹak
fiɹfokxif	fiɹfokkif
bɹiɹzodloɹk	pɹiɹdodloɹk
sisdɹɔɹβɔst	tistɹɔɹbɔst
ɣelsuɹdɸoɹl	geltʊɹdpoɹl
suɸustsɹɔɹt	supʊstsɹɔɹt
tseɹbnɔbzoɹt	tseɹpnɔbdoɹt
lɹifptsuɹfɹep	lɹifptsʊɹfɹep
ɸøɹβɶɹbɹul	peɹpaɹbɹul
xiɹgnɹɔfpbɹeɹs	kɪɹgnɹɔfppɹeɹs
lebɹubɹuɹt	lepɹupɹʊɹd
dɹedsoɹfbyɹl	tɹedsoɹfbɪɹl
gɹuɹldɹoɹgsiɹl	kɹʊɹltɹoɹksɪɹl
ɸumɸiɹblɹuɹp	pʊnpiɹplɹuɹb
ɣikpɸæptæl	gikpfaptal
fustniɹbfɹɔɹn	fustnɪɹbfɹɔɹn
ɸugsɹilut	pugsɹɪlʊd
sɹɛɹdɹiɹgɹist	sɹɛɹdɹiɹgɹɪst
lɹudɹitsnup	lɹudɹɪtsnʊb
βødfoɹbɹɛn	bedfoɹbɹɛn
niltsetzuɹ	nɪltsetdʊɹ
nɹɛɹdɣeɹbdɹɛɹn	nɹɛɹdgeɹbdɹɛɹn
tsɛlɹɔɹgsnæɹk	tsɛlɹɔɹksnaɹg
oktægβut	oktagbut
nistdɹɛlbɹof	nɪstdɹɛlbɹof
dɹefbɹiɹdɹɔɹk	tɹefpɹiɹtɹɔɹk
βøɹflɹiɹgpɸuɹn	beɹflɹɪɹgpfʊɹn
sɔlbɹusgɹiɹl	sɔlbɹusgɹiɹl
gɹodxinsiɹk	gɹodkɪnsɪɹk
ɸugɸœɹbɢuɹk	pugpɛɹbguɹg
sidɸufpbɹuɹt	sidpʊfppɹʊɹd
ɹeɹlnɹupdɹoɹp	ɹeɹlnɹupdɹoɹp
qɔgzofquns	kɔgdofkʊns
snɛgnɹofzɛɹn	snɛgnɹofdɛɹn
nɹæɹgβoɹbnɹɛɹf	nɹaɹgboɹbnɹɛɹf
βœɹbbɹiɹbdɹɛɹ	bɛɹppɹiɹpdɹɛɹ
tsæbpypɸɹæɹt	tsabpɪpfɹaɹd
fɹubdægfɔk	fɹubdagfɔk
fɛɹgbɹeɹgtsok	fɛɹgpɹeɹgtsok
sɔnsɹæɹlfɔk	sɔnsɹaɹlfɔk
nɛɸiɹltsoɹn	nɛpiɹltsoɹn
gɹænsgɹinup	kɹansgɹɪnʊb
lɹæɹndɹɛɹsgɹɔɹ	lɹaɹndɹɛɹskɹɔɹ
kæɹssɹæɹdlɹuk	kaɹssɹaɹdlɹʊg
ɸøɹbfæɹddæfp	peɹpfaɹtdafp
nukgɹɛlbɹiɹp	nukgɹɛlbɹɪɹb
snæɹziklɹɔt	snaɹtiklɹɔd
bɹeɹfloŋgɹɛk	bɹeɹflonkɹɛk
bɹɛɹbɹɛɹfɸos	pɹɛɹbɹɛɹfpos
ɸodtsuɹsnɹæt	podtsuɹsnɹad
sɛɹltsesgɹæɹf	tɛɹltsesgɹaɹf
qɔgbɹiɹldɹɛt	kɔgpɹɪɹltɹɛd
bɹɛɹnɔbdɹoɹt	bɹɛɹnɔbtɹoɹd
tsipɸisβœf	tsɪpfɪsbɛf
tsostdɹokbɹip	tsostdɹokpɹip
futɢobfɹæɹk	fʊtgobfɹaɹk
dæɹbɹiɹgɹɔɹt	daɹbɹiɹkɹɔɹd
βuɹsgɹestɣɛt	buɹskɹestgɛt
snepsnoɹgsæfp	snepsnoɹgsafp
tsiɹndɹuɹdfɹɔɹ	tsɪɹndɹʊɹtfɹɔɹ
zusdɹuɹsbɹek	dustɹuɹsbɹek
ɹɔsɸuɹfsot	ɹɔspuɹftod
fɔndɹɛfpsɔɹt	fɔntɹɛfpsɔɹd
tsiɹŋxenslɹol	tsiɹnkenslɹol
fɹɔɹŋgɹɔssɹæst	fɹɔɹnkɹɔssɹast
nustdɹɔsɹæɹk	nusttɹɔsɹaɹk
sɹiɹffikfɹæn	sɹɪɹffikfɹan
bɹɛɹdsnɛpsɔns	bɹɛɹdsnɛptɔns
siɹlidpyst	tɪɹlidpɪst
nɹiddɹoblɹɛɹn	nɹɪddɹoblɹɛɹn
fɹetnɹubɹol	fɹetnɹʊpɹol
sɛfpɸɛɹlbɹost	sɛfpfɛɹlbɹost
dɹiɹblɹiɹfæt	tɹɪɹblɹiɹfad
gɹɛɹbsɹoɹdsnip	gɹɛɹpsɹoɹtsnib
ɢufppɸudnɹip	gufppfudnɹib
likɸœɹssok	likpɛɹssog
sɹibɹiɹgpɸiɹf	sɹipɹiɹgpfiɹf
nɹɔkzifptsuns	nɹɔkdɪfptsuns
dɹuŋɣegbɹɔp	dɹʊngegbɹɔp
ɹɛɹgbɹunsfɹæk	ɹɛɹgbɹʊnsfɹak
tsæɹlsɹiɹgɸøp	tsaɹlsɹiɹgpep
aɹgɸøfbɹuɹl	aɹkpefbɹuɹl
qɔɹlgɹæɹlfɹuɹt	kɔɹlgɹaɹlfɹuɹt
sɛtɸonstsɛɹn	sɛtponstsɛɹn
sɹɛfpbɹæɹlɢɔst	sɹɛfppɹaɹlgɔst
ɸolbɹulsæɹn	polbɹʊlsaɹn
fɹiɹddɹeslɹuɹp	fɹiɹdtɹeslɹʊɹb
βoɹssnotfuk	boɹssnotfug
gɹɔɹdgɹoɹdsniɹk	gɹɔɹtkɹoɹdsnɪɹk
sniɹbgɹunsfuɹn	snɪɹpgɹʊnsfʊɹn
sɹukbɹoɹfgɹi	sɹukpɹoɹfkɹɪ
qusbɹællɔf	kʊsbɹallɔf
sinssnifpɸoɹt	tɪnssnɪfppoɹt
tsiɹbysɹep	tsɪɹbɪsɹeb
lɹubɹɛɹbgɹust	lɹʊpɹɛɹpkɹust
dɹuɹgɹæpdɹɛɹp	dɹʊɹkɹapdɹɛɹb
dɹiklɹuktseɹ	dɹɪklɹuktseɹ
pɸɔɹnseŋgɹiɹ	pfɔɹnsengɹiɹ
dɹæɹfiɹlsnɛɹk	tɹaɹfiɹlsnɛɹg
gɹɔɹfgɹɔlgɹens	kɹɔɹfgɹɔlkɹens
xiɹltsiɹdgɹiɹ	kiɹltsiɹtgɹiɹ
nɹuɹblufpɸɔp	nɹuɹblʊfpfɔp
soɹndɹiɹdɹos	soɹntɹiɹtɹos
βuɹgβoɹgɣiɹt	buɹgboɹggɪɹt
oɹŋgɹilsɛs	oɹngɹɪlsɛs
dɹokniɹsfɹɔp	tɹokniɹsfɹɔp
snuɹlbɹoddɹet	snʊɹlpɹoddɹet
sɛsziszɔɹt	tɛsdisdɔɹt
faaɹnup	faaɹnʊp
fusgɹæssuɹf	fuskɹassuɹf
pɸæsdɹeɹstsest	pfastɹeɹstsest
lensgɹutnɹɛɹn	lensgɹʊtnɹɛɹn
sninɹunsnɹiɹt	sninɹʊnsnɹiɹt
ɹɛklɹuɹgdɹep	ɹɛklɹuɹgtɹeb
lɹiɹlɹuɹlbɹufp	lɹiɹlɹʊɹlbɹʊfp
lɹofdɹilbɹis	lɹofdɹilbɹis
gɹæɹmβœɹgsnɛɹk	gɹaɹnbɛɹksnɛɹk
gænszɛɹdɹeɹk	gansdɛɹtɹeɹg
zikpɸiɹdnæs	dikpfɪɹdnas
dɹiɹsnɛbnuf	dɹiɹsnɛbnuf
snuɹgdæɹbkæt	snuɹkdaɹbkat
fɹupgɹoɹgfɹɔk	fɹʊpkɹoɹkfɹɔg
bɹistzɛbɢut	bɹistdɛbgud
sæɹsnodpɸɔfp	saɹsnodpfɔfp
ɹuɹfgɹɛstβøɹp	ɹuɹfkɹɛstbeɹb
zugɹæɹβuɹk	dʊkɹaɹbuɹk
nɔtsæɹsβuɹp	nɔtsaɹsbuɹp
xeɹsleɹgqoɹp	keɹsleɹkkoɹp
nɹikbɹusɔp	nɹɪkbɹusɔp
βoɹβossit	boɹbossɪd
snosβuɹbpɸiɹ	snosbʊɹppfiɹ
sneɹldɹustɸɔɹf	sneɹltɹʊstpɔɹf
loɹmβufnɹuɹk	loɹnbʊfnɹʊɹg
sɹædgæstdæp	sɹadgastdab
gɹæklidseɹn	gɹaklɪdseɹn
pɸufɹælluɹs	pfʊfɹalluɹs
ɢubnɔfpnæɹ	gʊbnɔfpnaɹ
snæɹsβɔnɛɹ	snaɹsbɔnɛɹ
ɸuɹgpɸɛɹsnɹin	pʊɹkpfɛɹsnɹin
fɹuɹszugbɹɛɹf	fɹuɹsdʊgpɹɛɹf
lɹolnunszuɹ	lɹolnunsduɹ
sneɹnlɹɔxes	sneɹnlɹɔkes
dɹoɹbɹefnɹiɹp	dɹoɹbɹefnɹɪɹb
suɹgɹizeɹt	sʊɹgɹideɹt
gɹɔɹgsubsuɹp	gɹɔɹgsʊbtʊɹb
gɹoɹsɹiɱfɹuɹf	kɹoɹsɹinfɹʊɹf
ɹiɹbɹuɹssɹɔp	ɹɪɹbɹʊɹssɹɔb
fɔnsdɹofpsnæf	fɔnstɹofpsnaf
ɸogbɹæsdɹæɹp	pogpɹasdɹaɹp
ɹitβønsɔɹ	ɹitbentɔɹ
ɛɹsnɔstgɹuk	ɛɹsnɔstgɹʊk
sɛfzikdɹæɹk	tɛfdikdɹaɹk
sɹiɹdfɔɹβif	sɹɪɹdfɔɹbif
dɹufbɹopqɔp	tɹufbɹopkɔp
sɔɹdbɹiɹdbɹɛns	tɔɹdbɹiɹtpɹɛns
nɛsnɹoɹɱfɹɛs	nɛsnɹoɹnfɹɛs
fɹiɹdgɹistfiɹ	fɹɪɹtgɹɪstfɪɹ
βuɹbtsɛdbɹus	buɹptsɛdbɹʊs
suɣellɹup	tʊgellɹub
nɹodligdɹust	nɹodligdɹʊst
pɸɛbgɹudneɹk	pfɛbkɹudneɹg
ɣɛɹlbɹuɹlfɛp	gɛɹlbɹʊɹlfɛp
bɹopgɹɛɹbzeɹ	pɹopgɹɛɹbdeɹ
fɹilfɔtzeɹf	fɹilfɔtdeɹf
sɹuɹɹiɹnufp	sɹʊɹɹɪɹnufp
nɹoslæɹgdɹoɹt	nɹoslaɹktɹoɹt
tsinsɹæɹbɣit	tsɪnsɹaɹbgɪt
nolsækɸis	nolsakpis
ɹɔkdɹeɹbsnup	ɹɔkdɹeɹpsnʊp
zupgɹuɹffiɹf	dupkɹuɹffiɹf
bɹugsnokbɹɛl	bɹugsnokbɹɛl
dɹuɹfdægɹup	tɹʊɹfdakɹʊp
lɹogɹɔgnɹens	lɹokɹɔgnɹens
bɹidsubpɸuɹl	bɹidtʊbpfuɹl
gæppɸɔɹzist	gappfɔɹtɪst
snɔtlɹipbyɹl	snɔtlɹɪpbɪɹl
fɹɔfsɛnsuɹ	fɹɔfsɛnsʊɹ
dɹensfiɹbnik	dɹensfiɹbnig
dɹæɹdlɔtbɹuɹs	dɹaɹdlɔtbɹuɹs
βoɹbsnugfuɹp	boɹpsnʊgfuɹb
gɹæɹlbɹædbyt	gɹaɹlpɹadbɪd
bɹuɹfqoɹgnɹut	bɹʊɹfkoɹgnɹʊd
suɹfnɔɹbluɹk	suɹfnɔɹplʊɹg
liɹzɔgpɸul	liɹtɔgpfʊl
sɔɹflɛɹgnoɹl	sɔɹflɛɹknoɹl
ɹestɣɛɹfsun	ɹestgɛɹftun
utsneksɹɔl	utsneksɹɔl
dɹuɹffænsæns	dɹʊɹffansans
gɹeɹllɹɔsgæt	gɹeɹllɹɔsgat
sɹuɹlɹɛstβøɹp	sɹuɹlɹɛstbeɹp
liɹfnɹeɹddɹɔp	lɪɹfnɹeɹdtɹɔb
gɹeɹbqoɹdɹæl	gɹeɹpkoɹtɹal
fæɹfsnæɹdbɹeɹp	faɹfsnaɹtpɹeɹb
tsuɹŋxitxɛp	tsuɹnkɪtkɛb
gɹuɹdɸøgdɹeɹk	kɹʊɹdpegdɹeɹk
nɹæpsɹibɹeɹp	nɹapsɹɪpɹeɹp
nɹidsnuɹdsuns	nɹɪdsnʊɹtsʊns
dɹopdɹiɹssoɹt	tɹoptɹiɹssoɹd
bɹɔlgɹifxest	pɹɔlkɹɪfkest
nɹuɹbnɔmbɹeɹs	nɹuɹpnɔnpɹeɹs
zumbɹɔɹdnɹiɹt	dunbɹɔɹtnɹiɹt
βøɹfɸɶɹbtsɔst	beɹfpaɹbtsɔst
gɹɛkβɔfpnɹok	gɹɛkbɔfpnɹok
lɹiɹlβøɹlfɹik	lɹiɹlbeɹlfɹig
quttsunzɔk	kuttsʊndɔk
gɹɛɹgpɸuɹgfi	kɹɛɹkpfuɹgfi
ɔɹdtæbɹɔɹk	ɔɹdtabɹɔɹk
bɹiɹfsɹiɹdβɔɹ	bɹiɹfsɹiɹtbɔɹ
sɹofppɸiɹsɢɔɹt	sɹofppfɪɹsgɔɹd
dɹiβikdɹus	tɹibikdɹʊs
ɸɶɹftsuplæk	paɹftsuplak
pybsiptæɹt	pɪbtɪptaɹd
zubɹokgɹust	dʊpɹokgɹʊst
dɹoɹbpɸæŋqɔɹt	tɹoɹppfankɔɹd
zunnɹɔfβø	dunnɹɔfbe
zɛɹbdɹɔnsfɹit	dɛɹbdɹɔnsfɹɪd
fɹɛɹdbɹiɹbsnus	fɹɛɹdpɹɪɹbsnʊs
gɹɛɹssiɹgdɹest	kɹɛɹstiɹgtɹest
nitlɹiɹbɣist	nɪtlɹɪɹbgɪst
sɹifgɹuɹgbɹoɹn	sɹɪfkɹʊɹgbɹoɹn
bɹɔɹbgɹuɹdzɛɹs	bɹɔɹbkɹʊɹtdɛɹs
fuɹmpɸɛɹlquɹk	fʊɹnpfɛɹlkʊɹg
zinspɸolsnen	dɪnspfolsnen
ɣɛfpdɹɛnsɹɔns	gɛfpdɹɛnsɹɔns
feɹfxiskæf	feɹfkiskaf
seneɹsnɹɛɹt	teneɹsnɹɛɹt
byɹgxedsnufp	bɪɹkkedsnʊfp
tsægtsinspɸeɹp	tsagtsinspfeɹb
fɔɹdɹuŋxit	fɔɹdɹʊnkɪt
lɹiɹgsistbɹɛs	lɹɪɹgsɪstpɹɛs
βolnɹinop	bolnɹɪnop
tsoɹdfepdɹɔf	tsoɹdfeptɹɔf
tsɔgtæɹgbɹiɹn	tsɔgtaɹkpɹiɹn
tænsnulɹæp	tansnʊlɹap
tsobbɹɔɹgɸɶl	tsobpɹɔɹkpal
suɹbɢuɢuɹl	tʊɹpgʊgʊɹl
zuɹdfoɹgnɛɹp	duɹdfoɹknɛɹb
gɹilipsos	gɹilɪpsos
lɹiɹdpɸuɹgliɹs	lɹɪɹdpfuɹklɪɹs
dɹekzeɹbtsɔt	dɹekdeɹbtsɔt
dɹunsɛɹdsuk	tɹunsɛɹtsʊg
xɛɹndɹumbɹeɹf	kɛɹndɹʊnbɹeɹf
uɹgβɶflɹuf	uɹgbaflɹuf
fɹɔpqosgæɹs	fɹɔpkosgaɹs
fɹuɹɱfɛtxefp	fɹuɹnfɛtkefp
nɹidgɹundɹiɹk	nɹidgɹʊndɹɪɹg
soɹndɹɛɹzɔ	soɹndɹɛɹdɔ
bɹedɹɛplɹufp	bɹedɹɛplɹufp
ɸuɹdnɛlsis	puɹtnɛltis
dɹɛplæɹlnoɹp	tɹɛplaɹlnoɹp
lɛɹdsuɹflɹiɹn	lɛɹtsuɹflɹiɹn
zuɹmpɸɔgsɹik	duɹnpfɔgsɹɪg
næɹlɣiɹfnep	naɹlgiɹfneb
bɹuplɹofpzɛst	bɹʊplɹofpdɛst
lɹonzɛmbɹiɹk	lɹondɛnbɹiɹg
gɹuɹggɹɔstzuɹt	gɹuɹggɹɔstdʊɹt
βøɹslɹɔɹlɢuf	beɹslɹɔɹlguf
nɹunsdɹɔnsɢus	nɹʊnstɹɔnsgʊs
ɸɔɹdnɹidbɹuɹn	pɔɹtnɹidpɹʊɹn
nɹiɹdpɸiɹmbɹons	nɹɪɹdpfiɹnpɹons
bɹiɹfɹɛtlɹiɹp	bɹiɹfɹɛtlɹiɹb
sɛɹgfiɹgpɸɛt	sɛɹgfiɹkpfɛd
bɹɔɹgfɹɛsus	pɹɔɹkfɹɛtʊs
lɹeɹzusnɹun	lɹeɹdusnɹun
gɹuflɹeldɹæt	gɹʊflɹeltɹat
lɹuɹbɹuɹɹɔt	lɹʊɹpɹuɹɹɔt
lɹɔɹmbɹɛɹfgɹil	lɹɔɹnpɹɛɹfgɹil
ɹendɹiɹlsɔk	ɹentɹiɹltɔg
ɣiɹglɛɹgnɹɔf	gɪɹklɛɹgnɹɔf
gɹinsxɛbɹiɹf	kɹɪnskɛbɹiɹf
dɹotfɹufnuɹp	tɹotfɹʊfnʊɹp
sniɹdsɹitdɹiɹl	sniɹdsɹɪtdɹɪɹl
bɹɛɹdsniɹgsɔɹs	pɹɛɹdsniɹgtɔɹs
ɹɛɹgβɶtsnuɹk	ɹɛɹkbatsnʊɹg
zedpɸɔkdɹop	dedpfɔktɹob
bɹɛnssitsɛl	bɹɛnstitsɛl
bɹuɹsɹusttsuɹf	pɹʊɹsɹʊsttsʊɹf
nɹættænsnɛk	nɹattansnɛk
lɹoɹdɣisnɹiɹt	lɹoɹdgisnɹɪɹt
snostliɹnɹiɹk	snostliɹnɹɪɹk
ɹiɹfgɹiɹgnɹɛɹp	ɹiɹfkɹiɹknɹɛɹp
seɹddæɹlnek	teɹtdaɹlneg
lɹæɹgnɛɹdsɹiɹk	lɹaɹgnɛɹtsɹɪɹk
zunsɹuɹbnɹe	dunsɹʊɹbnɹe
gɹukdɹeɹffuk	gɹuktɹeɹffʊg
suɹgtsofɢuf	tʊɹgtsofguf
lɹuɹssufpnɹɔp	lɹuɹssufpnɹɔb
sniɹlnɹunsquɹk	snɪɹlnɹunskʊɹk
snofdɹupnæt	snofdɹʊpnat
bɹɔstseɹŋqɔfp	bɹɔstteɹnkɔfp
niɹgɣifnɔɹn	niɹkgifnɔɹn
fɹeɹdɹɔnspɸiɹn	fɹeɹtɹɔnspfiɹn
dɹɛfpnɹibsɹoɹs	tɹɛfpnɹibsɹoɹs
fɹeɹdsɔɹglɛɹn	fɹeɹdtɔɹklɛɹn
aɹdfiɹdbɹɔn	aɹtfiɹdbɹɔn
snuklɹiknɹuɹp	snʊklɹɪknɹʊɹb
sɹiklɹiɹbɣik	sɹiklɹiɹpgɪk
ɸɔɹmβɶɹgdɹit	pɔɹnbaɹkdɹɪd
nodxiɹdqul	nodkiɹtkʊl
dɹuɹlnoɹblɹɛɹf	tɹuɹlnoɹblɹɛɹf
gɹestfeɹbtsæɹ	gɹestfeɹptsaɹ
dɹikfɹikzuk	dɹikfɹikdug
sɹuɹbgɹuɹdqɔɹl	sɹʊɹbkɹʊɹtkɔɹl
lɹufpsusbɹif	lɹʊfpsʊspɹif
sozudnuf	todudnuf
nɹɛgzoɹgsniɹs	nɹɛgdoɹgsniɹs
bɹɔfpgɹustqɔ	bɹɔfpgɹustkɔ
bybbɹikgɹɛɹl	bɪbpɹɪkgɹɛɹl
xeɸœɹbfɹif	kepɛɹpfɹif
fɹuɹdfɹɔpsnefp	fɹuɹtfɹɔpsnefp
pɸiɹbsnɔɹsluɹl	pfɪɹbsnɔɹsluɹl
lɛgsɹekbɹif	lɛgsɹekpɹif
lɹeɹbdɹustzop	lɹeɹptɹustdop
ɸuɹlgɹæɹgβul	puɹlgɹaɹkbul
bɹuɹgɸɶɸup	pɹuɹkpapʊp
gɹæssibbɹes	kɹastibbɹes
zobgæɹdxiɹk	dobgaɹdkɪɹg
bɹezudloɹk	bɹedudloɹg
sɛɹggɹɛpbɹɔɹp	tɛɹkgɹɛppɹɔɹb
gɹinsfifgɹuɹn	kɹinsfɪfgɹʊɹn
lulbɹenɹet	lʊlbɹenɹet
sɹiɹdsɔɹgnæɹt	sɹiɹdsɔɹgnaɹd
ɹustnɹugbɹoɹf	ɹustnɹugpɹoɹf
ɣittsæɹglist	gɪttsaɹglist
lɹiɹbnifɛp	lɹiɹbnifɛp
xɛstsɹumβɶl	kɛstsɹunbal
quɹdsunsuɹt	kʊɹtsuntuɹd
ɣɛɹffugpɸif	gɛɹffʊgpfɪf
bɹussenlust	bɹustenlʊst
ɔlkæɹglik	ɔlkaɹklik
dɹupsɹiɹspɸæk	dɹʊpsɹiɹspfag
βøtsuɹbsɹit	bettʊɹpsɹid
bɹogzuɹgquɹk	bɹogdʊɹkkuɹg
dɹolxigɹuɹ	dɹolkɪgɹuɹ
dɹistbɹeɹbbɹef	tɹɪstpɹeɹpbɹef
bɹebɹɛbfut	bɹepɹɛbfʊt
dɹugdɹæsgɹun	tɹʊgtɹasgɹun
nuɹdɹæɹglɔfp	nʊɹdɹaɹklɔfp
aplɔɹgfɹus	aplɔɹgfɹus
tsilfɹɛblek	tsilfɹɛbleg
suxiɹggɹot	sʊkɪɹggɹot
gɹiɹftsukbɹuɹp	gɹiɹftsʊkbɹʊɹb
xibɹesdɹen	kibɹestɹen
lɹifpdɹipdɹɔk	lɹifptɹipdɹɔk
gɹɛɹgβoɹlgɹæɹs	gɹɛɹgboɹlgɹaɹs
ziksefbɹot	dɪktefbɹot
quɹgsoɹlsɹɔɹt	kuɹksoɹlsɹɔɹd
gɹuɹbbɹɛkgɹɔɹp	gɹuɹpbɹɛkkɹɔɹp
qoɹbfɛstnɹuɹt	koɹpfɛstnɹʊɹt
lɹɛɹgsɔgpyt	lɹɛɹgtɔgpɪt
pɸæɹlɹænssniɹt	pfaɹlɹanssniɹt
djubniɹ	dɪʊbnɪɹ
tsilnɹobɹus	tsilnɹopɹʊs
tsuplisnɛɹp	tsuplisnɛɹp
dɹiɹfliɹdlɹæk	tɹiɹfliɹtlɹak
ɸuɹblæɹblɹuɹp	pʊɹblaɹplɹʊɹp
luɹmβɶslust	luɹnbaslust
gɹikfɹigβun	kɹikfɹɪgbʊn
bɹæɹfsnɔɹgfɹet	pɹaɹfsnɔɹkfɹed
bɹefplɹeɹlis	pɹefplɹeɹlɪs
aβœssɔst	abɛstɔst
dɹuɹbsɹisist	tɹʊɹpsɹisist
pɸiɹdgɹɔɹglɛf	pfɪɹtgɹɔɹklɛf
fɔtfɹɛtzup	fɔtfɹɛtdʊb
bɹisiɹnniɹp	bɹitiɹnnɪɹp
bɹɛqofptsoɹp	pɹɛkofptsoɹb
βøɹflɹoksuk	beɹflɹoksʊg
suɹsxiɹniɹl	tʊɹskiɹnɪɹl
fɹibzugsiɹk	fɹɪbdʊgsiɹg
lɹifpɸɹislɹoɹk	lɹifpfɹislɹoɹk
nuɹgdɹeɹgfɛp	nuɹgdɹeɹkfɛb
ɹudsæstzuɹf	ɹʊdsastduɹf
ɢuɹglɹeɹbtset	gʊɹglɹeɹptset
niɹnzɔɹnuɹk	niɹndɔɹnuɹg
gɹugfuɹbfæk	kɹugfʊɹpfag
gɹektsuɹŋgɹuɹl	gɹektsuɹnkɹuɹl
suŋqufppɸiɹl	tʊnkufppfiɹl
ɹiɹnsistæɹp	ɹɪɹnsɪstaɹb
dɹeɹldɹiɹndɹuɹt	dɹeɹldɹɪɹntɹʊɹt
gɹɔɹitsot	kɹɔɹitsot
zustsuɹdtsil	dustsuɹdtsɪl
sepsiɹgɸœk	sepsɪɹkpɛg
fɹoɹbluɹlfup	fɹoɹpluɹlfʊb
zɛlxikqɔf	dɛlkikkɔf
sussufpnɹo	tʊssufpnɹo
sɹættsɔɹstsæl	sɹattsɔɹstsal
ɸoɹbzɔby	poɹbdɔbɪ
bɹuɹlɣeɹgnɹæɹp	bɹuɹlgeɹknɹaɹb
sɹuklɹuɹfɢuf	sɹuklɹʊɹfguf
fɹebseɹŋgɹæp	fɹebteɹnkɹap
suplæɹlzuf	tuplaɹlduf
bɹiɹbnɔɹbsɹæf	pɹɪɹpnɔɹbsɹaf
tæfziktsɔɹl	tafdɪktsɔɹl
ɸɔɹltsiblɹen	pɔɹltsiblɹen
nɹeɹdlɹuɹdfɹop	nɹeɹdlɹʊɹdfɹop
qoɹsgɹɛɹbbɹuɹk	koɹsgɹɛɹbpɹuɹg
ɹuɹbsiɹdtsuk	ɹuɹpsiɹdtsug
lɔsgɹunsɣɛf	lɔsgɹunsgɛf
ɹigsɹɔfpbɹɛk	ɹigsɹɔfppɹɛg
ɹubzinsɔɹl	ɹubdintɔɹl
fɹibsubquɹk	fɹɪbsʊbkuɹg
sɹuɹsgɹæɹfgɹɔt	sɹuɹskɹaɹfkɹɔt
gɹoβoɹllɹuɹk	kɹoboɹllɹʊɹg
tsuɹdxetfɹɔɹk	tsuɹdketfɹɔɹg
pɸuɹbdɹupbɹip	pfuɹptɹupbɹɪp
dɹɔsɸøbɹoɹn	dɹɔspepɹoɹn
βossɹɔdfæs	bossɹɔdfas
dɹoɹsɹuɹgnɹɛk	tɹoɹsɹuɹknɹɛk
gɹepbɹæɹdqut	gɹepbɹaɹdkʊd
ɹiɹzoɸœf	ɹɪɹdopɛf
gɹifpɸøɹsfɔk	gɹɪfppeɹsfɔk
sulnɛɹgβɔf	tʊlnɛɹkbɔf
dɹeɹsbɹiɹfsuɹn	tɹeɹspɹɪɹfsʊɹn
gɹɔɹdɹeɹlɹiɹt	gɹɔɹtɹeɹlɹiɹt
bɹænɔtxefp	bɹanɔtkefp
dɹiɹssɔffɹuɹt	tɹɪɹstɔffɹuɹd
ɹiɹdlɹemɸøn	ɹɪɹdlɹenpen
bɹɛɹfsusdɹiɹl	bɹɛɹfsustɹɪɹl
gɹuɹmɸimɸoɹs	gɹuɹnpinpoɹs
bɹɔlgɹidluɹp	pɹɔlkɹɪdlʊɹb
lɹiɸɔɹbgɹoɹ	lɹipɔɹbkɹoɹ
zofɹoggɹiɹ	dofɹoggɹɪɹ
siklɹɔdgɹɛɹt	siklɹɔdkɹɛɹt
gɹiɹbdɹotgæp	kɹɪɹpdɹotgab
pɸeɹgnɔɹlpɸuf	pfeɹgnɔɹlpfʊf
sɹuɹfɸuɹgsɹoɹp	sɹʊɹfpʊɹksɹoɹp
ɹɛtnɹɛdɹel	ɹɛtnɹɛtɹel
bɹænnɹustfɹeɹt	bɹannɹʊstfɹeɹd
gɹɔbβiɱfɹons	gɹɔbbinfɹons
undɹiɹflɹuɹt	ʊndɹiɹflɹuɹd
bɹɛβuɹgɸut	bɹɛbʊɹgput
βɶdxeɹbnɹup	badkeɹbnɹup
sɔɹfnɹɔbnɹu	tɔɹfnɹɔbnɹu
fɹiɹlluɹggɹæɹt	fɹiɹllʊɹkgɹaɹd
suɹgɹɔɹftsɛt	sʊɹgɹɔɹftsɛd
nædɹɛstpɸoɹs	natɹɛstpfoɹs
gænsikdɹuɹt	gantiktɹʊɹd
iɹfsnæɹdβøst	iɹfsnaɹtbest
fɹæɹgsnutsot	fɹaɹksnʊttot
dɹænsxɛɹsgɹuɹs	tɹanskɛɹskɹuɹs
bɹɔsɣinsnoɹl	pɹɔsgɪnsnoɹl
bɹibbɹugsnæɹ	pɹibpɹugsnaɹ
qufdɹiɹddɹiɹt	kufdɹɪɹttɹiɹt
dɹɔtbɹɛmβɶɹp	dɹɔtbɹɛnbaɹb
gɹiɹbxɛɹgfɛns	kɹɪɹpkɛɹgfɛns
fuɹgsiɹsnit	fʊɹgtɪɹsnid
sɹufppɸoɹbgɹefp	sɹufppfoɹpgɹefp
tsuɹndɹikdɹɛl	tsuɹntɹiktɹɛl
sɹoβɶɹnup	sɹobaɹnup
sestɸuɹmbɹæn	testpʊɹnpɹan
sɹoɹdpynsβɶp	sɹoɹdpɪnsbab
dɹiɹbpɸoɹlqɔɹp	tɹɪɹppfoɹlkɔɹp
suɹsbɹoɹdsiɹl	suɹsbɹoɹtsɪɹl
fuɹdfɹubbyk	fʊɹdfɹubbɪk
seɹdsælsɔɹp	seɹdsalsɔɹp
aɹlɹulbɹufp	aɹlɹulpɹʊfp
snibfesneɹf	snibfesneɹf
quɹbfɔflɹeɹt	kʊɹpfɔflɹeɹt
lenspɸiɹndɹu	lenspfiɹntɹʊ
pɸæɹdtsɛfpɸɹæst	pfaɹdtsɛfpfɹast
lennæfβuk	lennafbʊg
gɹitpɸɛɹgpɸuɹk	gɹitpfɛɹgpfuɹk
snæɹfgɹubfɹuɹs	snaɹfkɹubfɹʊɹs
fɹɔɹddɹudzɔɹp	fɹɔɹddɹuddɔɹb
sɔŋxeɹŋɣip	tɔnkeɹngɪb
gɹetgɹiβɶns	gɹetkɹibans
bɹizensdɹiɹf	pɹidenstɹɪɹf
gɹeɹbɣiɹdseɹp	kɹeɹbgɪɹtseɹb
tsunlubgɹuɹp	tsʊnlubkɹuɹb
nɹæspɸɔɹgzɛt	nɹaspfɔɹgdɛd
uɹgdɹeɹdfɹiɹf	ʊɹkdɹeɹdfɹiɹf
bɹoɹgsnɔβɔn	bɹoɹksnɔbɔn
sniqɔɹdgɹæɹp	snɪkɔɹtkɹaɹp
ɣiɹbdɹuɹmbɹeɹs	giɹptɹuɹnpɹeɹs
fɹuɹbɣidlik	fɹʊɹbgidlɪg
snepdɹubgɹist	snepdɹʊbkɹist
nɹænsgɹɔɹgsɹɔk	nɹanskɹɔɹksɹɔg
lælnefpɸɛɹ	lalnefpfɛɹ
iɹgnæmɸɔɹn	iɹgnanpɔɹn
tsɔɹdpɸeɹnzɔt	tsɔɹdpfeɹndɔd
nɹɛstsɹætβɶs	nɹɛstsɹatbas
gɹubgɹɛfuns	kɹubkɹɛfuns
fɛɹbfɹɛɹdfɹɛp	fɛɹpfɹɛɹtfɹɛp
qutzudɹe	kʊtdʊtɹe
ɹefppɸunsdɹæɹt	ɹefppfunsdɹaɹd
gɹæɹdgɹeɹgsɹɔ	gɹaɹtgɹeɹgsɹɔ
gɹisfɹɔpsiɹt	kɹɪsfɹɔpsɪɹt
dɹusnisdɹæf	dɹusnɪsdɹaf
gɹiɹgsuɹnlɹɔns	kɹiɹgtʊɹnlɹɔns
nɔɹlɹɔɹglɹik	nɔɹlɹɔɹglɹɪk
fɹuɹllɹɔɹfpɸif	fɹʊɹllɹɔɹfpfif
lustbɹustβup	lʊstpɹustbʊb
snuɹndægxɛp	snuɹndagkɛp
ɢuɹllɹosgɹuk	gʊɹllɹoskɹuk
nɹiɹssɹoɹbnɹot	nɹɪɹssɹoɹbnɹod
nɹæfɸuɹɱfif	nɹafpʊɹnfɪf
dæsseɹbɸœɹk	dasteɹppɛɹg
segdɹæfbɹoɹp	tegdɹafbɹoɹp
feɹnlɹiɹŋgɹiɹt	feɹnlɹɪɹnkɹiɹt
tsuɹgbɹisdɹoɹf	tsʊɹkbɹistɹoɹf
lɹɔɹbqɔɹnifp	lɹɔɹpkɔɹnɪfp
byɹŋgɹeɹlbɹeɹp	bɪɹnkɹeɹlpɹeɹb
gɹikdɹisit	gɹɪkdɹɪtid
lɔpzɛɹgfɹok	lɔpdɛɹkfɹok
ɣɛfpɸufpbɹɛɹf	gɛfppʊfppɹɛɹf
zɔstæɹsɢoɹn	dɔstaɹsgoɹn
ɹiɹlxiflɹɔɹf	ɹiɹlkiflɹɔɹf
snuɹdsutβuɹs	snʊɹdsʊtbʊɹs
læɹdnɹɔnsuɹf	laɹdnɹɔntʊɹf
bɹupβiɹdfist	bɹupbiɹtfɪst
zɛɹsgɹiɹdɹot	dɛɹsgɹiɹtɹot
gɹoɹdsɹitnuɹk	gɹoɹdsɹitnʊɹg
sɹustbɹɛsniɹk	sɹustpɹɛsniɹg
sɹæfpgɹɛnsdɹuɹp	sɹafpgɹɛnstɹuɹp
ɢɔɹgzoɹzuɹl	gɔɹkdoɹtuɹl
fɹæɹsnuɹdlɹip	fɹaɹsnʊɹdlɹib
fɹæɹsɹiɹdtsuɹk	fɹaɹsɹiɹttsuɹg
xɛɹbdɹobfæl	kɛɹbdɹobfal
suɹbɹɛgfuɹt	suɹbɹɛgfʊɹd
ɹoɹβudgɹa	ɹoɹbʊdkɹa
gɹɔqulgɹuɹf	kɹɔkʊlkɹuɹf
tsæɹnnisu	tsaɹnnɪtʊ
siɸigsnɛɹk	tɪpigsnɛɹg
byɹbnɔdsnɛɹs	bɪɹbnɔdsnɛɹs
dɹɛɹdbɹeɹbpɸuɹp	tɹɛɹtbɹeɹppfʊɹb
bɹuɹgbɹɔbbɹuɹt	pɹʊɹgbɹɔbpɹʊɹt
listsogbɹik	listsogpɹik
idlɹeɹffɹiɹt	ɪdlɹeɹffɹɪɹt
quɹnsiɹldɹɔfp	kuɹnsɪɹltɹɔfp
snukbɹɛɹgdɹɔt	snukbɹɛɹktɹɔd
lipzuɹslut	lɪpduɹslut
ziqusnun	dikʊsnun
gɹupɸulɢut	gɹuppʊlgud
lɛstsinsfis	lɛsttinsfis
ziɹlβuɹnzek	dɪɹlbʊɹndek
gɹænspɸigsoɹp	gɹanspfɪgtoɹb
xɛɹbɹoɹgdɹif	kɛɹbɹoɹkdɹif
leɹdsnuɹddæɹp	leɹtsnʊɹddaɹp
gɹistnædbɹoɹk	kɹɪstnadpɹoɹk
ɢosbɹiɹbsit	gospɹɪɹbtɪt
dɹiɹlɹɛtdɹæp	dɹɪɹlɹɛtdɹab
snɛdgɹælgɹæɹt	snɛdgɹalkɹaɹt
lɹɛbgɹiffiɹk	lɹɛbgɹɪffɪɹg
ɸøɹgfɹiɹbpɸeɹs	peɹgfɹɪɹbpfeɹs
ɸilbɹidbɹik	pilpɹidpɹig
bɹoɹnziɹmbɹɔs	pɹoɹndɪɹnbɹɔs
βupsneɹltsiɹk	bupsneɹltsɪɹk
ɹɔffɹunsnɹep	ɹɔffɹunsnɹeb
nɔɹzigtsiɹl	nɔɹdɪgtsiɹl
ɹifsubɸɶ	ɹiftubpa
nɹuɹsfudgɹeɹt	nɹʊɹsfʊdgɹeɹt
lɔɹzɔɹɹul	lɔɹtɔɹɹʊl
pɸisβøkgɹɛɹt	pfisbekgɹɛɹd
bɹiɹlɛdnuɹn	bɹiɹlɛdnuɹn
qufgɹiɹgtsif	kufgɹiɹgtsif
βɔltsɔtfuk	bɔltsɔtfug
bɹuldɹusdɹil	bɹultɹʊstɹɪl
ɸœsoɹgsiɹk	pɛtoɹksɪɹg
dɹunsnɛptæp	dɹunsnɛptab
gægsɹuɹffiɹs	gagsɹʊɹffiɹs
dɹuɹbɹægɹɔs	dɹuɹbɹagɹɔs
ɔɹdsniɹdfɔn	ɔɹtsniɹtfɔn
dɹuɹŋxigzoɹp	dɹʊɹnkɪgdoɹb
zupziɹbgɹuɹk	dʊpdiɹpgɹuɹg
uɹbxitfɹɛn	uɹbkɪtfɹɛn
βukbɹɛfbɹoɹt	bʊkbɹɛfbɹoɹd
gɹiɹsgɹuɹdɢut	kɹɪɹsgɹuɹdgʊt
ɢufplusdɹep	gufplustɹeb
βɶbxiɹfbɹuf	babkɪɹfbɹʊf
qoddɹɔɹɣes	kodtɹɔɹkes
bɹæɹgxɛnsun	bɹaɹkkɛnsun
snuqɔɸɔp	snukɔpɔp
lɹɛɹdɣɛnsut	lɹɛɹdgɛntʊd
fukbydbɹuɹk	fukbɪdpɹuɹg
ɸɔsiɹddɹifp	pɔsiɹdtɹifp
noɹdɹɔkbɹun	noɹdɹɔkbɹun
qɔɹlbɹɔgdɹuɹl	kɔɹlpɹɔgtɹuɹl
qoɹbsnoɹbɣep	koɹbsnoɹpgep
bɹegbɹɛdɹuɹf	bɹegpɹɛdɹuɹf
nɹuɱfuslɹɛk	nɹunfuslɹɛg
linssɔɹsɹons	linssɔɹsɹons
dɹoklɹɔpɣiɹn	dɹoklɹɔpgiɹn
βɔbɹeɹsbɹɛɹt	bɔpɹeɹsbɹɛɹd
βɔstsutfɛ	bɔstsutfɛ
ɸɔdtæsxɛt	pɔdtaskɛt
ɣɛmbɹɛɹsqon	gɛnpɹɛɹskon
tsɔpnuɹɢuɹk	tsɔpnʊɹkuɹk
sninsɹɛszuɹp	snɪnsɹɛsduɹp
sɹɔɹlɹɛtdɹɛt	sɹɔɹlɹɛtdɹɛt
fɹɛdbɹidsnuɹf	fɹɛdbɹidsnʊɹf
bɹɛstpɸezɔs	bɹɛstpfedɔs
logsɹɔɹnuɹ	logsɹɔɹnuɹ
dɹɔgsɹɛɹnlɹif	dɹɔgsɹɛɹnlɹɪf
sɹensbɹɛɹnɛt	sɹenspɹɛɹnɛt
lɹutsefɣins	lɹutsefgɪns
zɔɹgzɔɹnluɹt	dɔɹkdɔɹnlʊɹt
dɹiɹnsniɹddɹi	tɹiɹnsnɪɹdtɹɪ
fɹædfɔɹsbɹuɹs	fɹadfɔɹsbɹʊɹs
dæɹglɔbpɸep	daɹklɔbpfep
βœdɸibsɹɛfp	bɛdpibsɹɛfp
ɣiɹbsɹɔdgɹuf	giɹpsɹɔdkɹuf
ɢufgɹuɹdnɹok	gufgɹuɹtnɹok
bɹiɹdlɹupɸut	bɹɪɹdlɹʊpfut
fiɹffɹæɹbɸus	fiɹffɹaɹppus
βoɹglɹɔɹbɹiɹp	boɹklɹɔɹpɹiɹb
βœtbɹubdɹust	bɛtbɹubdɹʊst
sæbɹinsnul	sabɹinsnʊl
tsiɹlsɹoɸɔp	tsɪɹlsɹopɔb
xeɹdzeɹŋɢuɹn	keɹtdeɹnguɹn
dɹunɹɛfɸɔɹt	tɹʊnɹɛfpɔɹt
sniɹgnɹɔɹbsnuɹp	sniɹknɹɔɹbsnuɹb
snopnæstgɹɔn	snopnastgɹɔn
bɹistloɹgfust	pɹɪstloɹkfust
sɔnsnoɹbɸɶf	tɔnsnoɹppaf
fegpɸeɹsɔp	fegpfeɹsɔb
ɹiɹgdɹeɹgbɹæɹf	ɹiɹktɹeɹkpɹaɹf
gɹoɹlnɹeslɹel	gɹoɹlnɹeslɹel
gɹepsnoɹgbɹɔt	gɹepsnoɹgpɹɔt
xiɹdɹiɹdæɹk	kiɹtɹɪɹdaɹg
tsuɹgnupsiɹp	tsuɹgnʊptiɹb
βɔnsgɹɔɹglut	bɔnsgɹɔɹklʊt
leɹmpɸuɹlgɹɛɹt	leɹnpfuɹlkɹɛɹt
fopɸɔdɹus	fopfɔdɹus
siɹbnɹixit	sɪɹbnɹikɪt
dɹɛɹbsnofsufp	dɹɛɹbsnoftufp
ɹulnɹeɹsɹiɹp	ɹʊlnɹeɹsɹiɹb
dɹudpysbɹoɹl	tɹʊdpɪsbɹoɹl
gɹɔstdɹæɹnsnæl	gɹɔsttɹaɹnsnal
tæbɸɔkbɹɛɹk	tabpɔkpɹɛɹk
uɹlgɹɛɹbdɹit	uɹlgɹɛɹpdɹid
sɹællɹɔɹdpɸɔl	sɹallɹɔɹtpfɔl
tsudluŋgɹun	tsʊdlunkɹun
βøstsænsnæs	bestsansnas
fɹeɹsɸɶdsɹit	fɹeɹspadsɹit
bɹiɹŋgæfdɹist	bɹiɹngaftɹɪst
ɛnspɸiɹslɛɹ	ɛnspfiɹslɛɹ
dɹugβublul	dɹugbublul
tsɔbgɹefgɹiɹk	tsɔbgɹefgɹiɹk
neɹβœɹstsɔs	neɹpɛɹstsɔs
ɹædsiβɶk	ɹadtɪbag
βiɹgdɹistsɔt	biɹkdɹɪstsɔt
sniffɹuɹlsuɹp	sniffɹʊɹltʊɹb
dɹipgɹoffɔɹk	tɹɪpgɹoffɔɹk
dɹustsuɹbsæɹp	dɹustsʊɹpsaɹp
nɹuɹbfætpɸɛt	nɹuɹpfatpfɛt
fɹuɹsɔtluɹt	fɹʊɹsɔtluɹd
sniɹgnɹæɹsxeɹt	snɪɹknɹaɹskeɹt
tsɛstdɹinslæɹp	tsɛsttɹinslaɹb
næstɸøfbɹit	nastpefpɹɪt
liɹbɹɔɹgbɹif	lɪɹpɹɔɹgpɹif
pɸɔksænliɹt	pfɔksanlɪɹd
snoɹlluppɸuɹt	snoɹllʊppfuɹd
fɹɛstɸoɹsɣɛp	fɹɛstpoɹsgɛb
dɹuɹnzoɹsɹeɹs	dɹʊɹndoɹsɹeɹs
gɹitdɹuɹldɹop	gɹɪtdɹʊɹldɹop
nɹugfiβoɹf	nɹugfɪboɹf
gɹoɹbpɸokgæɹp	gɹoɹppfokgaɹb
ɹiɹdsinstsiɹt	ɹiɹtsɪnstsiɹd
dɹulifbɹeɹf	tɹʊlɪfbɹeɹf
uɹiɹgɹoɹk	uɹiɹgɹoɹg
feɹbsɹifnɛt	feɹbsɹɪfnɛt
ɹeɹfliɹdsofp	ɹeɹflɪɹdsofp
ɣiɹβœfbɹop	gɪɹpɛfpɹob
bɹæɹlsesβœɹk	bɹaɹltesbɛɹk
ɢutfuɹmpyɹf	gʊtfʊɹnpɪɹf
gɹiɹsfolnɹef	kɹiɹsfolnɹef
sɔɹfnuɹbsnuɹn	tɔɹfnʊɹbsnuɹn
ɹiɹmbɹustsɹæk	ɹiɹnpɹustsɹak
ɸɶɹddɹæftsɔɹt	paɹddɹaftsɔɹt
luɹdfulgæns	lʊɹdfulgans
nɹuɹɹuɹfsɹæɹn	nɹuɹɹʊɹfsɹaɹn
lugɹiɹdxiɹk	lugɹiɹtkɪɹg
qubtsufpbɹiɹp	kʊbtsufppɹɪɹp
fɹiptsuɱfɹɔɹk	fɹiptsunfɹɔɹg
fɹeggɹeɹβis	fɹeggɹeɹbis
bɹɛɹfoɹlɸut	pɹɛɹfoɹlpʊt
pɸiɹdɣɛɹsɹoɹt	pfɪɹdgɛɹsɹoɹd
bɹiɹggɹæknæfp	bɹiɹggɹaknafp
nɹelsnuɹdβons	nɹelsnuɹtbons
xiɹbfɹæɹgɹɔt	kiɹpfɹaɹkɹɔd
dɹoɹgβɔsxɛɹk	tɹoɹgbɔskɛɹk
aɹdɹuɹggɹins	aɹtɹʊɹkkɹins
bɹobsɹoɹɹuf	bɹobsɹoɹɹʊf
fɹæbnɹɔstsif	fɹabnɹɔstsɪf
nuɹdbɹeɹfbɹoɹ	nuɹdbɹeɹfbɹoɹ
fɛstbɹuɹdβul	fɛstpɹʊɹtbʊl
sɹeɹbsiltsip	sɹeɹbsiltsib
snɔɹdæppyk	snɔɹtappɪg
læɹbβøɹgpɸeɹf	laɹbbeɹkpfeɹf
nɹɛɣifpɸɛɹn	nɹɛgɪfpfɛɹn
βɶstnustsuɹt	bastnusttuɹt
ɹikpɸuɹgsup	ɹɪkpfuɹktup
lɹæbsilsi	lɹabtiltɪ
fiɹbgɹitsil	fɪɹbkɹittɪl
bɹɔɹbdɹɔlnɹæk	pɹɔɹptɹɔlnɹak
zisɛɹblins	ditɛɹblins
bɹæfpɸɹiɹnsnɔɹp	bɹafpfɹɪɹnsnɔɹb
snignuddɹɔɹf	snignʊdtɹɔɹf
sɹolsifdɹɔɹl	sɹolsɪfdɹɔɹl
siɹntsuɹbbɹɔɹs	tɪɹntsʊɹbpɹɔɹs
tsuɹbdɹɔɹbɹiɹt	tsuɹptɹɔɹbɹɪɹt
nuɹbzukpɸes	nuɹbdʊkpfes
sɔddɹuɹzuɹn	sɔdtɹuɹtʊɹn
fæɹddɹeɹsβoɹf	faɹtdɹeɹsboɹf
gɹæɹsgɹoɹbɹens	kɹaɹsgɹoɹbɹens
xiɹlbɹuɹɔk	kiɹlbɹuɹɔg
ɸifplɹɔpdɹuns	pifplɹɔptɹʊns
fɹiɹbzuɹllik	fɹiɹbdʊɹllɪk
nɹifpnɛlɸøfp	nɹifpnɛlpefp
pɸisotdɹiɹk	pfitotdɹɪɹg
sneflɹundɹeɹk	sneflɹʊntɹeɹk
lɔfitbɹɔst	lɔfitpɹɔst
sɔɹbpɸedlɹoɹk	sɔɹppfedlɹoɹk
lunsnebβons	lʊnsnebbons
sɹɛbɢuɹæɹf	sɹɛbguɹaɹf
ɸɶxiɹslɹis	pakiɹslɹis
ogβœɹgbɹɛfp	ogbɛɹkbɹɛfp
snuɹgtsɔɹlɢut	snuɹgtsɔɹlgut
tsuɹfɢopɸiɹt	tsuɹfgoppiɹt
nɔɹfsnɛɹgpɸɔk	nɔɹfsnɛɹgpfɔk
uɹdxiɹdtsuɹl	ʊɹtkɪɹttsuɹl
fugɹeɹgpɸoɹf	fʊkɹeɹgpfoɹf
fuɹbzitβœt	fuɹpdɪtbɛt
dæɹgdɹugɹuɹt	daɹktɹʊkɹuɹd
xidgɹunsfɛk	kidkɹunsfɛk
unsfuɹfnɹof	unsfuɹfnɹof
ɸupqobseɹf	pupkobseɹf
gɹæbɹeɹgβɔɹ	gɹabɹeɹkbɔɹ
bɹoggɹuɹspɸuk	pɹogkɹʊɹspfug
sefpnɹufɸɔɹs	tefpnɹʊfpɔɹs
ɹuɹsdɹesbɹus	ɹuɹsdɹespɹʊs
sɹænsnuɹdbɹuɹf	sɹansnuɹdpɹuɹf
pɸætxeɹdsoɹp	pfatkeɹtsoɹp
gɹeɹlɹuɹssɹofp	kɹeɹlɹuɹssɹofp
bɹɛnsβiɹgɹuɹs	pɹɛnsbiɹgɹuɹs
gɹetsiɹbtsɛɹk	gɹetsiɹbtsɛɹg
ɣiɹniɹblip	gɪɹnɪɹblɪb
gɹiɹgβoɹdkæɹt	gɹiɹgboɹtkaɹd
nɹiŋxɛɹbzet	nɹɪnkɛɹbdet
soɹlxeɹbquɹk	soɹlkeɹbkuɹk
gɹɔglulβiɹf	kɹɔglulbiɹf
pysdɹuɹfle	pɪsdɹʊɹfle
sɹeffɹoɹstsen	sɹeffɹoɹstsen
ɸuglɹenssuɹk	puglɹenssʊɹg
βɔɹddɹɔɣin	bɔɹdtɹɔgɪn
pɸægtsɛɹbpɸɔɹk	pfagtsɛɹppfɔɹk
dɹɛsbɹunsus	tɹɛspɹʊnsus
nɹutfɹuknok	nɹutfɹʊknog
snutfuldɹins	snutfultɹɪns
xigbɹustfiɹk	kigpɹustfiɹk
dɹoknɔɹgdɹæɹp	tɹoknɔɹktɹaɹb
tsɔɹlɹilis	tsɔɹlɹɪlis
pɸuɹslɔltsins	pfʊɹslɔltsɪns
zuɹlɹusæt	dʊɹlɹusad
snɔɹfiɹŋxeɹl	snɔɹfɪɹnkeɹl
iɹdlɹufsɹoɹl	ɪɹtlɹufsɹoɹl
sɔtbɹæɹlbɹut	sɔtpɹaɹlbɹud
dɹiɹbsuɹfβuk	dɹɪɹptuɹfbʊk
nɔɹbfɹudpɸefp	nɔɹbfɹudpfefp
bylgæblɹuns	bɪlgablɹuns
fiɹsgɹɛstɢuɹk	fɪɹskɹɛstguɹg
sɹitgɹinsist	sɹɪtkɹɪnsɪst
bɹɔɹsɹeɹntsæɹs	bɹɔɹsɹeɹntsaɹs
sɹufsufdɹit	sɹʊfsufdɹid
sifbɹɔɹbsɔɹk	sifpɹɔɹptɔɹk
bɹuɹftsuɹbɹis	pɹʊɹftsʊɹbɹis
sɹɔfpdɹɔɹflɹuɹt	sɹɔfptɹɔɹflɹuɹd
lɹigtsɔɹdsiɹ	lɹɪgtsɔɹtsiɹ
pɸuɹsquɹbnɹɛɹf	pfuɹskuɹbnɹɛɹf
snustluɹdpɸuk	snʊstlʊɹdpfʊg
tsefsɔɹbfofp	tseftɔɹpfofp
nɹifgɹustsɛɹn	nɹɪfgɹʊstsɛɹn
suɹbɹinnup	tʊɹpɹinnʊb
ɣinnɹofæp	gɪnnɹofap
selbɹensgɹest	selbɹenskɹest
lesdɹinsfɹeɹl	lestɹɪnsfɹeɹl
ɹenlɹædpɸɛns	ɹenlɹadpfɛns
oɹbfɔlot	oɹbfɔlod
ɹigfælɔs	ɹɪgfalɔs
βinnɛɹdpɸus	binnɛɹtpfus
ɢudfiɹdtsop	gʊdfɪɹdtsob
dɹesdɹufdɹɛɹ	dɹesdɹufdɹɛɹ
pɸiɹgβussniɹf	pfiɹgbʊssnɪɹf
gɹeɹfsɹubɹus	kɹeɹfsɹupɹus
tsiɹdxeɹdɹa	tsɪɹdkeɹdɹa
gɹuɹntsiɹllæfp	kɹʊɹntsiɹllafp
nɹepsiɹsdæk	nɹepsiɹsdag
tsiɹggɹukpɸɛɹ	tsiɹggɹʊkpfɛɹ
ɢɔdsiɹsqon	gɔdtɪɹskon
tsipsuɹggɹol	tsɪptʊɹggɹol
gɹunɹuɹɣil	gɹʊnɹʊɹkil
bɹegsɹoɹggɹust	bɹegsɹoɹkkɹust
snɔɹbsnuɹɛ	snɔɹpsnʊɹɛ
ɹoɹbdɹuluk	ɹoɹptɹulug
gɹuɹdlɹisɔp	kɹʊɹtlɹisɔb
tseszoɹmβis	tsesdoɹnbis
tsɛfsɹɔstpɸol	tsɛfsɹɔstpfol
bɹuɹgdɹidzɔp	pɹʊɹkdɹɪddɔb
xeɹgzuɹszeɹp	keɹkduɹsdeɹb
ɸosdɹoɹbsuk	postɹoɹpsʊg
tsiɹzunslɛɹt	tsɪɹtʊnslɛɹt
sefsulbɹæf	teftulbɹaf
ɸupɸiɹbdɹæl	pʊppiɹpdɹal
sniklɹeɹsdɹiɹn	sniklɹeɹsdɹɪɹn
pɸɛsgæɹɢuɹt	pfɛsgaɹguɹd
nɹɔdpɸeɹbsnɔp	nɹɔdpfeɹbsnɔp
gɹiɹdnɹiklɹuɹs	gɹiɹdnɹiklɹuɹs
snɛnsɢɔbnɹut	snɛnsgɔbnɹud
bɹokbɹæɹssɔɹn	bɹokpɹaɹssɔɹn
gɹænsɹiɹldɹiɹk	kɹansɹiɹltɹɪɹg
gɹuɹlnɹuɹgsin	gɹʊɹlnɹʊɹksɪn
βɔɹsbɹomβuɹs	bɔɹspɹonbʊɹs
lɹissuɹfsna	lɹissʊɹfsna
gɹæɹbsɹikβut	gɹaɹpsɹɪkbud
ɣenslɹuɹdsek	genslɹʊɹdtek
βudɹigfɹoɹp	butɹɪgfɹoɹp
sɹuɹfgɹibsnuk	sɹuɹfkɹɪbsnuk
bɹɔklɹuɹgpɸeɹk	pɹɔklɹʊɹkpfeɹk
gɹustbɹuɹgdɹuɹk	gɹʊstpɹʊɹkdɹʊɹg
ɸɔɹstsuldɹæɹs	pɔɹstsʊldɹaɹs
fɹutlɹiɹntsuɹt	fɹʊtlɹiɹntsuɹd
dɹɔsdɹuɹlbɹip	tɹɔstɹʊɹlbɹip
gɹɔɹsdæɹdsiɹp	kɹɔɹsdaɹtsɪɹb
fikbɹoɢɔɹk	fikpɹogɔɹg
zoɹbɸɔɹdlɔɹt	doɹppɔɹtlɔɹt
nuksnutsneɹ	nuksnʊtsneɹ
pɸofpsuɹbɣi	pfofptʊɹpgi
nɔnɛɹlnɛɹk	nɔnɛɹlnɛɹg
gɹæɹsfubɹɔ	gɹaɹsfʊbɹɔ
gɹæɢuɹgfæɹn	gɹaguɹgfaɹn
kæɹlsiɹmpɸuɹk	kaɹltiɹnpfʊɹg
sesɹuɹlbɹɔɹf	sesɹʊɹlpɹɔɹf
ɹuɹfleɹltsoɹk	ɹuɹfleɹltsoɹg
fæppɸepbɹɛɹt	fappfeppɹɛɹt
dɹobsneniɹk	dɹobsnenɪɹg
snɔlbɹibdɹɛs	snɔlbɹibtɹɛs
lukdɹɔɹgdɹok	lukdɹɔɹgtɹok
pɸoɹfdɹænsdɹuɹt	pfoɹfdɹanstɹuɹt
dɹoɹgsɛgfɹus	dɹoɹksɛgfɹʊs
dɹægdɹɛgbɹuɹt	tɹagtɹɛgbɹuɹt
ziɹmbɹæɹnnɹɛf	diɹnpɹaɹnnɹɛf
sɹɛɹβuɹstsɔs	sɹɛɹpuɹstsɔs
tseddɹɔɹnnɹuɹ	tseddɹɔɹnnɹʊɹ
tsiddɹestgɹoɹf	tsɪddɹestgɹoɹf
tsupɸustɸɶɹp	tsupfustpaɹb
bɹuɹblɹɛɹggɹup	pɹuɹplɹɛɹkkɹʊp
xɛstsefpzuɹp	kɛsttefpduɹp
sɹɔndɹebsnons	sɹɔntɹebsnons
lɹolbɹofpgɹiɹk	lɹolpɹofpkɹiɹg
pɸuɹsniɹlɸuɹl	pfuɹsnɪɹlpʊɹl
bɹwøɹdβœɹs	bɹueɹdbɛɹs
pɸɛɹdbɹiɹndɹæɹp	pfɛɹdbɹiɹndɹaɹp
lɹɛstsiɹbɹil	lɹɛstsɪɹpɹil
xeɹgɹuɹsgɹit	keɹkɹʊɹskɹɪt
dɹeɹfqukɢuɹp	tɹeɹfkʊkguɹb
fɛblɹuɹlnɔst	fɛblɹuɹlnɔst
fɹensɸɶpgɹɔk	fɹenspapkɹɔg
byfgɹænsɸɶp	bɪfgɹanspap
ɸiɹgɹunslɹæɹt	piɹgɹunslɹaɹd
suɹnzuɹdpyɹp	tʊɹnduɹtpɪɹp
bɹiɹbbɹusβuɹk	pɹɪɹppɹʊsbuɹg
bɹenssikzuɹf	bɹenssɪkduɹf
zinsɢoɹsɹil	dinsgoɹsɹil
βœgpystpɸɔs	bɛgpɪstpfɔs
xiɹbtsuɹdsek	kɪɹbtsuɹtseg
pɸɔktsæŋgɹæs	pfɔktsangɹas
gæbqubdɹɔɹt	gabkubtɹɔɹt
pɸæɹgɸøɹgsnu	pfaɹkpeɹgsnu
lɹɔnsβøɹflɛk	lɹɔnsbeɹflɛk
dɹeɹfɢɔgbɹeɹl	dɹeɹfgɔgpɹeɹl
bɹiɹbɣinnæk	pɹɪɹpginnak
eɹβipsuk	eɹpipsʊk
bɹinsgɹæpgɹut	pɹinskɹapgɹut
nɹiɹfɹellɹeɹt	nɹɪɹfɹellɹeɹt
βɶbsɹeɹbsop	babsɹeɹpsop
pɸɛstgɹeɹfdɹet	pfɛstkɹeɹftɹet
dɹoɹdqɔsɔɹk	dɹoɹdkɔtɔɹk
fɹeɹgβœnslɹɔst	fɹeɹgbɛnslɹɔst
ɸiffɛlɹol	piffɛlɹol
nɹidɹɔɹfnæf	nɹitɹɔɹfnaf
sɹɛbɹɛɹfpɸɛns	sɹɛpɹɛɹfpfɛns
fɹitfɹæɹdgɹof	fɹitfɹaɹtgɹof
xiɹlβøɹnlɔɹk	kɪɹlbeɹnlɔɹg
legtsiɹzeɹk	legtsiɹdeɹk
lɹiflɹiɹnnɹul	lɹiflɹɪɹnnɹul
gɹoɹnɹiɹlsnuɹt	gɹoɹnɹɪɹlsnʊɹd
tsonsbɹiɹŋxɛɹn	tsonsbɹɪɹnkɛɹn
gɹæglɹiɹlfiɹp	gɹaglɹiɹlfiɹb
sɹiɹsniɹnzoɹ	sɹiɹsnɪɹndoɹ
dɹɔŋgɹisziɹt	dɹɔnkɹɪsdiɹt
βɶɹgɹæɹdnɹiɹp	baɹgɹaɹdnɹɪɹp
bɹifpnɹɛɹfzɛɹp	pɹifpnɹɛɹfdɛɹp
gɹɔstnɹɔɹbβɶt	gɹɔstnɹɔɹpbad
ɹɛɹflɹɛfpɢup	ɹɛɹflɹɛfpgup
bɹiɹnɹæɹdbɹik	bɹɪɹnɹaɹtpɹɪk
sniɹgsnɔɹdsnɔɹt	snɪɹgsnɔɹdsnɔɹt
aɹgfɹeɹnin	aɹkfɹeɹnɪn
dɹedfɔzi	dɹedfɔdɪ
fɛɹnzonssɹiɹt	fɛɹndonssɹɪɹd
bɹifpgɹɛdgɹeɹt	pɹifpkɹɛdkɹeɹd
ɣepnɹoldɹuɹp	gepnɹoltɹʊɹb
fɛɹgsufβøɹf	fɛɹgtufbeɹf
ɔɹsfɹeɹgtæɹt	ɔɹsfɹeɹktaɹt
sɹifpkæɹlsip	sɹifpkaɹltɪb
tsɔɹgɸɶɹgɹɔt	tsɔɹgpaɹgɹɔd
ɸɔɹlsensnɔɹp	pɔɹlsensnɔɹp
soɹftsigdɹɔɹt	toɹftsɪgdɹɔɹt
ɣɛɹgdɹosot	gɛɹgtɹotod
lidlɹunsbɹuɹp	lidlɹunspɹuɹb
nisβugnɛp	nisbʊgnɛb
nɹɔbgæɹlfɹɔɹk	nɹɔbgaɹlfɹɔɹk
gɹeɹnsɔɹdlust	kɹeɹnsɔɹdlʊst
tsɔɹdtsiɹgdɹuɹp	tsɔɹttsiɹgtɹʊɹb
suɹgdɹuɹndɹop	tuɹkdɹuɹndɹob
snæfɣiɹbgɹɛɹs	snafgiɹpkɹɛɹs
sedfinlɔɹt	tedfinlɔɹt
lɹiɹiɹŋqɔɹk	lɹiɹɪɹnkɔɹk
ɹɔɹdgædɹuɹk	ɹɔɹdgatɹʊɹg
dɹinsnɹiɹgluɹp	tɹinsnɹɪɹkluɹb
ɹɛɹzɔɹdsnɔɹp	ɹɛɹtɔɹtsnɔɹp
nɛgfɹoɹgnɹoɹp	nɛgfɹoɹknɹoɹb
zɔszugzɔɹf	dɔsdugdɔɹf
bɹuɹnlekdɹɛɹ	bɹuɹnlekdɹɛɹ
ɢoɹsɹiɹɱfæp	goɹsɹiɹnfab
sɛɹsfuɹfsɔɹp	tɛɹsfuɹftɔɹb
nɹuɹɢɔsnɹit	nɹuɹgɔsnɹit
βifpsɹɛfgɹiɹn	bifpsɹɛfkɹɪɹn
gɹigɹistdɹuns	gɹɪgɹɪstdɹuns
bɹɔkfɹitfɹɔɹk	pɹɔkfɹɪtfɹɔɹg
fɹifzɛfɸuɹ	fɹifdɛfpʊɹ
βøɹɢugdɹest	beɹgugtɹest
sɹiɹgsiɹdtsu	sɹɪɹgsiɹdtsu
sɹæɹfqudɹoɹk	sɹaɹfkʊtɹoɹk
snɔɹblutdɹɔp	snɔɹbluttɹɔb
ɸuɹgɢoɹsoɹ	pʊɹggoɹsoɹ
lɹoɹglɹæɹsqoɹp	lɹoɹklɹaɹskoɹb
fussuɹŋgɹuɹl	fustʊɹngɹʊɹl
fɹinninsnɹiɹn	fɹinninsnɹiɹn
fuɹdɹiltsæn	fuɹdɹɪltsan
gɹoɹbtsestsuɹ	gɹoɹbtsestsʊɹ
gɹuɹdæbsɹeɹp	kɹʊɹdabsɹeɹp
ximβœfpsuɹl	kɪnbɛfptuɹl
lɹoɹnlusbɹiɹs	lɹoɹnluspɹɪɹs
tsɔfpgæɹnlɹiɹs	tsɔfpgaɹnlɹɪɹs
gɹɔɹggɹiksɹik	kɹɔɹggɹiksɹɪk
ɹistgɹuɹsɔfp	ɹɪstkɹʊɹsɔfp
lɹigɹɛkæɹt	lɹigɹɛkaɹd
dɹeklɹɔtfus	tɹeklɹɔtfus
dɹufsidtsæɹk	tɹʊftidtsaɹk
gɹoɹgsnuɹnin	gɹoɹksnʊɹnin
lɛɹglɹiɹgsiɹk	lɛɹklɹɪɹgsiɹk
bɹutlɹuɹfnɹæɹn	pɹʊtlɹʊɹfnɹaɹn
dɹissɔpbɹɔt	dɹissɔppɹɔt
gɹæɹntsælsɹu	kɹaɹntsalsɹʊ
bɹoɹmbɹænstsil	bɹoɹnpɹanstsil
snɛfbɹiɹbsɹɛs	snɛfpɹiɹpsɹɛs
nibgɹæɹfpɸip	nibgɹaɹfpfɪb
snelbɹiɹgxik	snelpɹɪɹkkɪg
βoɹgpɸæɹβup	boɹkpfaɹpʊp
βøɹbdɹupɸus	beɹpdɹuppus
nɹiɹɣinuk	nɹiɹgɪnuk
sɹæɹbβiɹbɹɛɹs	sɹaɹpbiɹpɹɛɹs
unsbɹɛfpxit	ʊnsbɹɛfpkɪd
nɹeɹbzifpβol	nɹeɹpdɪfpbol
sɔllɔfsiɹk	sɔllɔfsiɹk
βuɹdgɹɛɹsβuɹt	bʊɹdgɹɛɹsbʊɹd
tsɔgfɔnslɹɔp	tsɔgfɔnslɹɔb
ɹosβiɹfiɹt	ɹosbiɹfɪɹt
næɹdzilɹɔɹl	naɹddilɹɔɹl
bɹofbɹɛɹdbɹufp	bɹofbɹɛɹtbɹʊfp
snɔɹdseɹdsoɹt	snɔɹdseɹttoɹd
nɹigkæpgɹiɹf	nɹigkapkɹɪɹf
βøɹdgɹuɹsdɹip	beɹtkɹuɹstɹip
sɛɹgsnɔstɣip	tɛɹksnɔstgɪb
noksɹeɹgsɹu	noksɹeɹgsɹʊ
pɸɔɹgziɹssep	pfɔɹkdiɹsteb
bɹoɹbtsæɹblɹɔɹ	pɹoɹbtsaɹplɹɔɹ
fiklɹugɹeɹt	fɪklɹukɹeɹd
fɹɛnssniɹdɹuk	fɹɛnssnɪɹtɹuk
snægɣeɹsbɹil	snaggeɹsbɹɪl
gɹiɹfbɹɛbzɔl	gɹiɹfpɹɛbdɔl
tsɛɹspɸeɹdgɹiɹp	tsɛɹspfeɹtkɹɪɹp
nɹuɹbbɹɛbɹæk	nɹuɹppɹɛpɹak
ɢoɹndæstnæɹt	goɹndastnaɹt
soɹdɹɔllen	toɹtɹɔllen
ɣɛggɹuɹmbɹæɹp	gɛgkɹʊɹnpɹaɹb
xibɹudfɹɔns	kɪpɹudfɹɔns
suɹlɣɛpβɔst	tʊɹlgɛpbɔst
nitdæɹdpɸef	nɪtdaɹdpfef
tsæplɹoɹdɸøf	tsaplɹoɹdpef
ɣikɣisttsoɹt	gɪkgisttsoɹd
nɹiɹŋɢɔdɹoɹn	nɹiɹngɔtɹoɹn
bɹepβissneɹp	pɹepbissneɹb
fɹetneɹdɢoɹs	fɹetneɹdgoɹs
bɹuɹbdɹibsuɹn	pɹuɹbdɹɪbsuɹn
dæɹstsimbɹæɹs	daɹstsinpɹaɹs
bɹæɹssɹipdɹɛɹp	pɹaɹssɹɪptɹɛɹb
bɹustɢodɣe	pɹustgodge
lɹiɹsɹudnik	lɹiɹsɹʊdnig
nɹoɹgtsefqoɹf	nɹoɹktsefkoɹf
fɹofpgɹɔɹsqons	fɹofpkɹɔɹskons
bɹubnɹoɹdɹuk	pɹubnɹoɹtɹuk
sæɹmpɸɛfpɸɔɹp	saɹnpfɛfpfɔɹb
ziɹbnistnɹæp	diɹbnistnɹap
ɢokniɹgzit	gokniɹkdit
nɹeɹdɣɛɹsdɹoɹt	nɹeɹdgɛɹsdɹoɹd
dɹistsnisgɹoɹp	dɹistsnisgɹoɹp
pyfpdɹufsɹɔt	pɪfptɹʊfsɹɔd
fonsbɹɛɹgleɹf	fonsbɹɛɹkleɹf
ɸɔɛgɹɔɹ	pɔɛgɹɔɹ
fuɹdqofnɹɛɹp	fʊɹdkofnɹɛɹp
snugtsiɹddæɹ	snugtsiɹddaɹ
lɹunɹibtsis	lɹunɹɪbtsɪs
bɹeɹllɹɔzen	bɹeɹllɹɔden
sɹɛɹsgɹupɸæɹf	sɹɛɹsgɹʊpfaɹf
xigsoɹbsniɹ	kigtoɹbsnɪɹ
fɹuɹbɹɔlsof	fɹuɹbɹɔltof
xepsɛɹdxin	kepsɛɹdkɪn
fɔbβœtfæs	fɔbbɛtfas
sɔɹdgɹɔkfæst	sɔɹtkɹɔkfast
ɸolnifpbɹen	polnɪfppɹen
gɹɔɹlnɹæɹdnɹæp	kɹɔɹlnɹaɹdnɹap
soɹsfɛtɢɔp	toɹsfɛtgɔb
gɹɛnsdɹuɹbsɹoɹk	kɹɛnstɹuɹbsɹoɹk
βøpdɹiɹzip	bepdɹiɹtib
ɢufɸœnni	gʊfpɛnnɪ
sɹuɹdtsæɹgzɛɹt	sɹʊɹdtsaɹgdɛɹt
βœsgɹɔfbɹɔɹp	bɛskɹɔfpɹɔɹp
fɹiɢuɹntsep	fɹɪguɹntsep
nopɣeɹfqot	nopgeɹfkot
xeɹgfɹindɹæɹp	keɹgfɹindɹaɹb
nɹiɹɹɛksɹiɹk	nɹiɹɹɛksɹiɹg
βiɹdβœstlɔɹk	biɹdbɛstlɔɹk
fælsnoɹbβœɹs	falsnoɹbbɛɹs
fɹizublɹif	fɹɪdublɹɪf
dɹifɸɶɹbyt	dɹɪfpaɹpɪd
snoɹfɸugnɹiɹf	snoɹfpʊgnɹiɹf
listlɹæɹsɸøst	listlɹaɹspest
gɹiɹbnɛɹŋɢuns	kɹiɹbnɛɹnguns
xɛtbyssɹuk	kɛtbɪssɹʊg
bɹæɹdziɹbgɹiɹk	bɹaɹddɪɹpkɹiɹk
tækɣɛstsɔp	takgɛstsɔb
gɹæsukgɹo	kɹatʊkgɹo
βunɹustdæs	bʊnɹʊstdas
leɹdsnosxiɹl	leɹtsnoskiɹl
ɢɔɹgsɹæfsnæɹt	gɔɹgsɹafsnaɹd
bɹeɹgpɸɛfdɹuɹf	bɹeɹgpfɛftɹuɹf
sniɹszulsuɹs	snɪɹsdulsuɹs
gɹudsɛkdɹɔɹs	kɹʊdsɛktɹɔɹs
bɹuɹdnɹembɹeɹt	pɹʊɹtnɹenbɹeɹd
dɹɛtdɹɛfgɹefp	dɹɛtdɹɛfgɹefp
pɸiɹlsnistbɹil	pfiɹlsnɪstbɹɪl
ɹipgɹiɹgquɹt	ɹɪpkɹɪɹgkʊɹd
lɹæbɣɛɹdzɔp	lɹabgɛɹddɔb
foɹŋgɹoɹggɹɔɹt	foɹnkɹoɹggɹɔɹd
fɹubdæblins	fɹubdablins
tsobɹeɹɱfɹɛk	tsobɹeɹnfɹɛk
ɢuɹluɹlnɹoɹf	guɹluɹlnɹoɹf
xenssibgɹɔɹs	kenssibgɹɔɹs
tsiɹdɸœɹdsɹɔɹp	tsiɹtpɛɹdsɹɔɹp
sɹulnɹænsdɹens	sɹʊlnɹansdɹens
fɔɹbnistdɹɔp	fɔɹbnɪstdɹɔb
snɛnslɹintsɛɹp	snɛnslɹɪntsɛɹp
ɣeɹɹuɸøɹs	geɹɹupeɹs
ɹiɹlsnufpgɹuɹp	ɹɪɹlsnufpgɹʊɹp
ɹefsoknɹon	ɹeftoknɹon
tsutgɹestgɹɛɹn	tsutgɹestgɹɛɹn
bɹoɹbβœɹddɹiɹt	bɹoɹbbɛɹttɹɪɹt
nusziɹbbɹuɹt	nʊsdiɹbpɹʊɹd
ɹæslɹeɹdɹuns	ɹaslɹeɹdɹuns
gɹiltsoɹbseɹp	kɹɪltsoɹbseɹb
pɸænsxegdɹeɹn	pfanskegtɹeɹn
zɛlfusfɹɔɹp	dɛlfʊsfɹɔɹp
gɹɔgnufgɹiɹp	gɹɔgnʊfkɹiɹb
zɔɹldɹɔstfɹɔɹk	dɔɹldɹɔstfɹɔɹk
ɣeɹdxiɹdsɹuɹp	geɹdkiɹtsɹuɹp
lɹuɹndɹonssɹæɹp	lɹʊɹndɹonssɹaɹp
qudsnæɹdsnuk	kudsnaɹtsnug
bɹɛɣɛɹgtsɛ	bɹɛgɛɹgtsɛ
sulnɔɹbbɹiɹt	sulnɔɹppɹiɹd
pɸɔbdɹunlɹæst	pfɔbtɹunlɹast
fɹædɹiɹgsɹæf	fɹadɹiɹksɹaf
gɹiɹddɹegɹɔɹp	kɹɪɹtdɹekɹɔɹp
fɹinsnæɹdβɶns	fɹinsnaɹdbans
nɔbɢuɹdbɹeɹt	nɔbgʊɹdpɹeɹt
dɹestnɔstsuɹl	dɹestnɔstsuɹl
ɹɛspɸiɹfɢoɹt	ɹɛspfɪɹfgoɹt
nɛŋqudɹuɹk	nɛnkudɹuɹk
suɹlgɹimbɹek	suɹlkɹɪnpɹeg
fɹupɸɹɔɹbsoɹk	fɹʊpfɹɔɹbtoɹk
dɹæpɸæsnip	tɹapfasnɪb
eɹdbyɹldɹeɹf	eɹtbɪɹltɹeɹf
gɹestdɹustbɹons	kɹesttɹʊstbɹons
pɸɛɹgdɹɔlbɹoɹp	pfɛɹgdɹɔlpɹoɹb
bɹusnelpɸæk	pɹusnelpfak
fiɹmβuɹdsiɹt	fiɹnbʊɹdtiɹd
suɹdzufbɹuɹt	sʊɹddufbɹuɹt
fɔmpɸuɹsβøɹp	fɔnpfuɹsbeɹp
ɣiɹlsnifpdɹif	giɹlsnifpdɹif
bystgɹitgɹuɹl	bɪstkɹɪtkɹuɹl
gɹiɹβiɹldɹik	gɹɪɹpiɹltɹig
ɸɶkfotkæs	pakfotkas
zɛpsuɹbnɔn	dɛpsuɹbnɔn
sedsɹɛɹβuɹt	sedsɹɛɹpʊɹt
tsulβøŋgɹiɹt	tsulbengɹiɹt
quɹnɹoɹgbɹɔɹf	kuɹnɹoɹgbɹɔɹf
dɹɔɹfɸœɹlβɔɹt	tɹɔɹfpɛɹlbɔɹt
nɹiŋgɹiɹdxi	nɹingɹiɹdki
ɹetbydnuɹt	ɹetbɪdnuɹt
ɢoɹbɢuɹdnut	goɹpgʊɹtnʊd
sɹæɹsisɸit	sɹaɹsispit
lɔdqusttsoɹp	lɔdkʊsttsoɹp
dɹobbɹoɹlfɹɔɹk	tɹobpɹoɹlfɹɔɹg
ɹifpsnoɹlbɹæf	ɹifpsnoɹlpɹaf
fistdɹɔstqɔt	fɪsttɹɔstkɔt
sensɸuɹbfup	tenspʊɹpfub
dɹukfɔfpsnik	dɹʊkfɔfpsnik
tsɔnslɹiɹbβoɹs	tsɔnslɹiɹpboɹs
dɹinsnɔgzuɹ	dɹinsnɔgdʊɹ
gɹælgɹuɹdxiɹp	kɹalkɹuɹtkiɹb
sukfɹidbɹɛɹk	sʊkfɹɪdpɹɛɹg
fɹuɹnsnɛɹlsnuf	fɹuɹnsnɛɹlsnuf
xeɹdsniɹnɹuɹk	keɹtsnɪɹnɹʊɹk
ɸɶflikβok	paflikbok
næɹdxistbɹɛɹn	naɹdkistpɹɛɹn
ɸɔɹdbɹuɹɹoɹt	pɔɹtbɹuɹɹoɹt
bɹustfɔstlus	pɹustfɔstlʊs
ɹesɔɹgɹuk	ɹesɔɹkɹuk
nælsofsnuf	nalsofsnuf
snwøpɸɹɔf	snuepfɹɔf
lɹɛkbɹutfel	lɹɛkpɹutfel
liɹɢokɢuɹk	liɹgokguɹk
gɹuɹbgɹesiɹl	kɹuɹpgɹesiɹl
sɹuntsiblɹiɹt	sɹuntsɪblɹiɹd
sɹetnɹiɹdɢuɹt	sɹetnɹiɹdgʊɹd
fɹænsnɹæɹszon	fɹansnɹaɹsdon
bɹuɹgnɹiɹbloɹt	bɹuɹgnɹɪɹbloɹd
ɸutfeɹgæt	pʊtfeɹkat
ɹædnɹikluɹp	ɹadnɹiklʊɹp
qudɹæfploɹs	kutɹafploɹs
ɹælsɹɛɹslɹuk	ɹalsɹɛɹslɹug
ziɹdzɔksɛst	dɪɹtdɔksɛst
ɸunsɹisnɹæp	punsɹisnɹap
sɹiɹfsɹusgɹik	sɹɪɹfsɹuskɹik
bɹedzɔɹdnuns	bɹeddɔɹtnuns
tsolsnolsnɔɹl	tsolsnolsnɔɹl
pɸɛɹgdɹutgɹuɹn	pfɛɹgdɹʊtgɹʊɹn
snoɹfβɔfsɹus	snoɹfbɔfsɹʊs
tsiɹbgæpnons	tsiɹbgapnons
βigsefɔl	bigsefɔl
pɸedtsætsuk	pfedtsatsug
sɹuɹfbɹɛɹgsu	sɹʊɹfbɹɛɹgtʊ
suɹdbɹɛtbɹæɹp	sʊɹtbɹɛtpɹaɹb
bɹizusdɹet	bɹidusdɹed
bɹulɹiɹdqo	bɹʊlɹiɹtko
nɹufidfek	nɹufɪdfeg
isɛnɹɔɹn	ɪtɛnɹɔɹn
fɹensɢuɹgsnɛs	fɹensguɹksnɛs
noɹlgɹoɹflofp	noɹlgɹoɹflofp
ɢuɹlfɹɛɹgzuk	guɹlfɹɛɹkdug
pɸippɸiɹsgɹiɹp	pfɪppfɪɹsgɹɪɹb
lɹɛɸœɹflɛst	lɹɛpɛɹflɛst
feɹbnɹɛɹlbɹil	feɹbnɹɛɹlpɹil
gɹiɹglɹoɹlsil	gɹɪɹklɹoɹlsil
siɹdsnifzok	tɪɹtsnifdog
snɔpyɹbgɹiɹp	snɔpɪɹpkɹiɹp
bɹɔɹftsɛkdɹɔɹt	bɹɔɹftsɛkdɹɔɹd
sɹitnɹotsɹif	sɹitnɹotsɹif
ɢoffɛɹsfiɹn	goffɛɹsfɪɹn
bjofpniɹn	bɪofpniɹn
bɹuɹgtsipzuk	bɹʊɹgtsipdʊg
bɹɛklidæɹt	pɹɛklidaɹd
nifdɹugfɹi	nɪftɹʊgfɹi
ɸuɹglɛstpɸuɹk	puɹglɛstpfʊɹk
nɛɹfdɹeɹfseɹp	nɛɹfdɹeɹfseɹp
nɹodbɹænsgɹɔɹp	nɹodbɹanskɹɔɹp
snimbɹesɸik	sninbɹespig
dɹobɹotgɹiɹk	dɹopɹotkɹɪɹk
ɹuɸœktsæɹf	ɹʊpɛktsaɹf
snɔɹgsnæɹbβœp	snɔɹgsnaɹpbɛp
nɹiɹdxɛɹgtsɛl	nɹɪɹdkɛɹgtsɛl
ɸɔɹfbɹeɹdlæfp	pɔɹfpɹeɹdlafp
ɹosttsæfloɹt	ɹosttsafloɹd
ɣedbɹuɹdsɹop	gedpɹʊɹtsɹob
suɹsβœɹlgɹins	tʊɹsbɛɹlkɹins
ɹæbɹuɹgnoɹt	ɹapɹuɹknoɹd
insnustfip	insnʊstfɪp
ɸœɹsfɹæɹbgɹi	pɛɹsfɹaɹbgɹɪ
suɹdɹɛɹbfɹiɹf	tʊɹtɹɛɹpfɹiɹf
bɹeltsinsβoɹp	pɹeltsinsboɹp
bɹiɹdlɹoɹgquɹt	bɹɪɹdlɹoɹkkʊɹd
dɹæɹdɸunszeɹf	dɹaɹdpʊnsdeɹf
nɹifsɹɔɹbɸɶt	nɹɪfsɹɔɹppad
dɹɔɹzukfufp	tɹɔɹdʊkfufp
bygɢɔnlɹup	bɪggɔnlɹup
segbɹufpɸuɹk	tegpɹʊfpfʊɹg
tsænsbɹæɹlsifp	tsanspɹaɹltifp
bɹigɢoksniɹl	bɹɪggoksnɪɹl
ɸifbɹɛpdɹoɹ	pifbɹɛptɹoɹ
nɛɹgbɹindɹiɹl	nɛɹgbɹɪndɹiɹl
nɹoflɹækfi	nɹoflɹakfi
pystpɸekɸuɹl	pɪstpfekpʊɹl
bɹæɹglolsuk	pɹaɹklolsʊk
gɹɔɹggɹɛɹβi	kɹɔɹkkɹɛɹpi
ɢustɣeɹssɹeɹp	gʊstgeɹssɹeɹp
iɹspɸɔŋgɹeɹ	iɹspfɔnkɹeɹ
dɹænsnɛɹbpɸop	tɹansnɛɹbpfob
gɹuffoɹnsnɛt	kɹuffoɹnsnɛt
gɹuɹgsɹɔlgæɹf	gɹuɹgsɹɔlgaɹf
lɹulfɹuɹsnɹop	lɹʊlfɹʊɹsnɹob
funstsiɹftsit	funstsiɹftsɪd
zɔndɹeɹggɹoɹp	dɔndɹeɹgkɹoɹb
iɹsiɹbtsæɹs	iɹsiɹptsaɹs
dɹeɹɱfɹiɹlsifp	dɹeɹnfɹɪɹlsifp
tsissufquɹp	tsissufkʊɹp
bɹɔɹlɛɹnlɹin	bɹɔɹlɛɹnlɹin
gɹefsnæɸol	gɹefsnapol
ustxibnet	ustkɪbned
fɹɛfsɛlfɹɛk	fɹɛfsɛlfɹɛk
sneɹbnensin	sneɹbnentin
nɹuɹdgɹeɹmpɸæɹp	nɹʊɹdkɹeɹnpfaɹp
ufgɹofpbɹɔt	ufkɹofppɹɔt
luknɛɹdɹuk	lʊknɛɹtɹug
kæɹfigɸit	kaɹfigpid
fɹeɹbsnoflɹiɹk	fɹeɹpsnoflɹiɹg
nɔflɹɛdxɛk	nɔflɹɛdkɛg
nɹɛɹgpɸɛɹgbɹɛk	nɹɛɹgpfɛɹkpɹɛg
sɹæɹgɸøkɸu	sɹaɹkpekpu
qoɹdzeɹbxiɹl	koɹddeɹpkiɹl
sɛnslɹɔndɹɔk	tɛnslɹɔntɹɔk
lɹedlɹoɹgsuɹf	lɹedlɹoɹgsʊɹf
lɹiɹbfæsnop	lɹɪɹpfasnop
nifplistsɹɔɹt	nɪfplɪstsɹɔɹt
lonsgɹɔbɸul	lonsgɹɔbpʊl
suɹfɹigtsɔɹ	tuɹfɹigtsɔɹ
pɸisgɹɔbɸɔns	pfɪsgɹɔbpɔns
sɔɹfsuɹlsnufp	tɔɹfsʊɹlsnʊfp
lɹɔnsɸifppɸet	lɹɔnspifppfed
niɱfɔɹbɣif	ninfɔɹbgɪf
lɹuɹgsnɔdqot	lɹʊɹksnɔdkot
dɹistpyɹgseɹf	dɹɪstpɪɹgseɹf
pɸiɹbloɹsɸɔɹl	pfɪɹploɹspɔɹl
fidβœɹzɔns	fɪdbɛɹdɔns
lulsɹuɹdnɹuɹf	lʊlsɹuɹdnɹuɹf
snunsudβok	snuntudbog
dɹiɹdbɹænsbɹop	dɹiɹdbɹanspɹop
ɣebfɛɹsfɹuns	gebfɛɹsfɹʊns
dɹɔɹnsɹæŋgɹiɹp	dɹɔɹnsɹangɹɪɹb
pɸæɹggɹofpnɹip	pfaɹkkɹofpnɹɪb
sɹitpɸɔɹsgɹuns	sɹɪtpfɔɹsgɹʊns
lɛɹgdɹuɹβɶɹl	lɛɹktɹuɹpaɹl
bɹiɹbfiɣel	bɹiɹpfɪgel
gɹuɹllæɹfdɹis	kɹuɹllaɹfdɹis
qoppɸufɢut	koppfufgʊd
dɹiɹzɛfæns	dɹiɹdɛfans
ɸɶɹddæɹlɹɔk	paɹtdaɹlɹɔk
gɹeɹgbɹoɹgsnup	gɹeɹgpɹoɹksnup
zustfɹuɹndɹuɹl	dustfɹuɹndɹuɹl
lɹɛɹffɹolnɹɛt	lɹɛɹffɹolnɹɛd
fuɹfɹoɹbbɹɔɹf	fʊɹfɹoɹpbɹɔɹf
zeŋgɹissnuɹn	dengɹissnuɹn
gɹɔɹmbɹegɹuk	gɹɔɹnbɹegɹʊg
dɹeglɛstbɹiɹf	tɹeglɛstbɹiɹf
bɹofæɹβuns	bɹofaɹpʊns
gɹensɹæɹgɢuɹt	kɹensɹaɹkgʊɹt
sænsɔbgɹiɹn	sansɔbkɹiɹn
dɹigɸɶgfɛk	dɹɪgpagfɛg
ɹeɹfgɹægquɹt	ɹeɹfgɹagkʊɹd
dɹiɹnitnɹuf	tɹiɹnitnɹʊf
nunsɹusdɹek	nʊnsɹʊstɹeg
zuɹbxiɹsfɹiɹn	dʊɹbkɪɹsfɹiɹn
pɸustsɛmbɹul	pfustsɛnbɹʊl
dɹufbɹigsɹuɹt	dɹufpɹigsɹʊɹt
zuɹŋgɹissna	duɹnkɹɪssna
gɹuɹddɹonsnɹiɹt	gɹʊɹddɹonsnɹɪɹd
bɹuɹdnɹistgɹoɹt	pɹuɹdnɹistkɹoɹd
suɹllɹæŋqɔɹn	sʊɹllɹankɔɹn
gɹutzissnik	kɹutdɪssnɪk
nubfiɹgsɛɹf	nubfiɹksɛɹf
dɹɛllɹuɹlsnust	dɹɛllɹuɹlsnust
pyɹdgɹesgɹuɹf	pɪɹtgɹesgɹuɹf
gɹæbbɹiɹbgɹus	gɹabpɹiɹbgɹus
gɹoɹlgɹunlɹæɹn	gɹoɹlgɹʊnlɹaɹn
sæɹlfɹifptæst	saɹlfɹɪfptast
dɹɛɹgfɔpɸoɹ	dɹɛɹkfɔppoɹ
dɹolbɹuklɹiɹs	dɹolpɹʊklɹɪɹs
itqubgɹeɹp	ɪtkʊbgɹeɹp
iɹbpɸɛlɸoɹs	ɪɹbpfɛlpoɹs
dɹiplæɹgnɹoɹp	tɹiplaɹknɹoɹb
qupzebpɸist	kʊpdebpfɪst
qunslɹunsfɹoɹs	kʊnslɹʊnsfɹoɹs
lɹumβiɹdfɔns	lɹunbiɹdfɔns
ɢuɹsneɹnlɹiɹt	guɹsneɹnlɹiɹt
sebnipbɹɛɹs	tebnipbɹɛɹs
fɹɛmpɸifsɔt	fɹɛnpfifsɔd
ɢosnɔnɹoɹp	gosnɔnɹoɹb
bɹɛksespɸæɹl	pɹɛktespfaɹl
bɹistβuɹlsɹef	pɹistbʊɹlsɹef
dɹuɹbsɹæbpɸuɹf	tɹʊɹpsɹabpfʊɹf
byɹɢuttsiɹs	bɪɹkʊttsɪɹs
fɹolɹæfbɹiɹp	fɹolɹafpɹɪɹb
aɹlsegqɔs	aɹlsegkɔs
quɹlfɹɔfbɹɔn	kuɹlfɹɔfpɹɔn
bɹiɹbɢodɹæɹk	pɹɪɹpgodɹaɹg
βuɹɣɛsgɹoɹs	buɹgɛskɹoɹs
lugsnikbɹɔf	lʊgsnikbɹɔf
ɸɶdsiɹgβoɹp	padsiɹkboɹb
lilfuɹfsɹiɹ	lɪlfuɹfsɹiɹ
ɣeɹgtsumβɶs	geɹgtsunbas
pɸuɹdgɹifpbɹiɹs	pfʊɹtkɹɪfpbɹɪɹs
dɹifɹɔkdɹɛk	tɹɪfɹɔktɹɛg
ɸoɹgpɸɔɹnɹust	poɹkpfɔɹnɹʊst
ɹoɹnɹinsgɹɛɹp	ɹoɹnɹinsgɹɛɹb
xitɣɛktsuɹf	kɪtgɛktsuɹf
pɸifpgɹistsæf	pfɪfpgɹɪstsaf
bɹiɹllɹisgɹuɹn	pɹɪɹllɹiskɹʊɹn
gɹendɹeɹgdɹæf	gɹentɹeɹktɹaf
ɢublɹuɹdgɹuɹk	gublɹʊɹtkɹʊɹg
sotpɸɛɹgnɹuɹf	totpfɛɹknɹʊɹf
nɹuɹβolβɶɹk	nɹuɹpolbaɹg
lilluɹbnɹæfp	lɪlluɹpnɹafp
dɹiɹdnuɹggɹɔɹk	tɹɪɹtnuɹggɹɔɹk
nɹefpɸɹoɹgze	nɹefpfɹoɹkde
sɹɛnnɹiggɹuɹp	sɹɛnnɹiggɹuɹp
dɹiɹɢulsnun	tɹɪɹgʊlsnun
snæstgɹætfɹeɹp	snastkɹatfɹeɹb
dɹɔɹbɹilbɹol	tɹɔɹbɹilpɹol
dɹɛnlɹuɹdgɹus	dɹɛnlɹʊɹdkɹʊs
suɹmβuɹdsniɹp	tuɹnbuɹtsnɪɹb
gɹæɹgbɹɛɹlɹoɹt	gɹaɹkbɹɛɹlɹoɹd
idqɔɹdɹik	ɪdkɔɹtɹɪg
dɹodɹibfɹuɹs	dɹodɹɪbfɹʊɹs
nuɹdɹigæɹp	nuɹdɹigaɹp
nipgælɢuns	nɪpgalguns
fwøɹfbɹuɹn	fʊeɹfbɹuɹn
gɹiɹbgæɹndɹup	gɹɪɹpgaɹndɹub
ɸœɹggɹɔgnust	pɛɹkgɹɔgnust
leɹɱfuɹbsɛɹs	leɹnfʊɹbsɛɹs
xɛɹdtsoɹɛɹp	kɛɹdtsoɹɛɹp
sɹæɹmɸɔfpdɹoɹl	sɹaɹnpɔfpdɹoɹl
pɸuɹbnofɹes	pfʊɹpnofɹes
pɸiɹfɸidtæst	pfɪɹfpidtast
dɹiŋgɹofɹoɹt	tɹinkɹofɹoɹt
sɹeɹgɸuɹŋxɛl	sɹeɹkpuɹnkɛl
nufpniklɹik	nufpniklɹɪk
dɹuɹfβɔnɹiɹf	dɹʊɹfbɔnɹiɹf
ɣitsoɹdbɹuɹk	gɪtsoɹtbɹuɹk
nofbɹiɹbbɹin	nofpɹiɹbpɹɪn
bɹukbɹiɹspɸuk	bɹʊkbɹɪɹspfʊg
dɹæɹbxiɹlut	dɹaɹbkiɹlud
ikqonslɹeɹk	ikkonslɹeɹg
nægpɸuddɹufp	nagpfuddɹufp
sɔkfuɹfsɹiɹp	sɔkfuɹfsɹiɹb
bɹoklɹuɹdxeɹt	pɹoklɹuɹdkeɹt
lɹæɹdbɹæɹβœk	lɹaɹdbɹaɹbɛk
bɹuɹβunsnæp	pɹuɹpunsnab
sɹɔsɹɔɹlɣiɹl	sɹɔsɹɔɹlgɪɹl
sɔbbɹifgɹuɹn	tɔbpɹifkɹʊɹn
lɹopbɹɛɹlgɹæɹk	lɹopbɹɛɹlgɹaɹk
lɹiɹgloɹgnuf	lɹiɹkloɹknʊf
lɹiɹsfuddɹɔn	lɹiɹsfudtɹɔn
lɹɔkβɶfptsæns	lɹɔkbafptsans
dɹoɹnnɹetbɹæk	tɹoɹnnɹetbɹak
neɹsneɹfbɹifp	neɹsneɹfbɹifp
lɹɔɹbɹɛɹgsil	lɹɔɹbɹɛɹgtɪl
ugɢuɹdbɹæɹs	ʊggʊɹdbɹaɹs
bɹelsedla	bɹeltedla
ɸoksiɹɣiɹk	poksiɹkɪɹg
fulnubɹæns	fʊlnʊbɹans
ɸœɹdtsæɹdgɹet	pɛɹttsaɹdgɹed
bɹeɹsgɹiɹdgɹust	bɹeɹskɹiɹtkɹʊst
gɹeɹdnidsɹɔɹl	kɹeɹdnɪdsɹɔɹl
snɛmbɹɔdɹup	snɛnpɹɔdɹup
lɹæɹblɛsɸiɹk	lɹaɹplɛspiɹk
nɹubzeɹsnuk	nɹubdeɹsnʊk
bɹænssuɹslɔɹs	bɹanstʊɹslɔɹs
bɹiɹgdɹikfɔp	bɹiɹgtɹikfɔp
βɔɹdtæktsɛk	bɔɹdtaktsɛk
dɹæstgɹombɹɔɹs	dɹastkɹonbɹɔɹs
ɹætlɹiɹbɹik	ɹatlɹɪɹpɹig
sɹæɹdxɛɹsɹis	sɹaɹdkɛɹsɹɪs
dɹognɹufzut	dɹognɹufdʊt
dɹuɹdnɹeldɹeɹp	tɹʊɹtnɹeltɹeɹp
pɸɛbɹɛɹɱfuɹn	pfɛpɹɛɹnfʊɹn
ɹonsgɹɛɹsnif	ɹonsgɹɛɹsnɪf
bɹindɹæstsɹiɹ	pɹɪndɹastsɹɪɹ
upβɔnzuɹk	ʊpbɔnduɹk
βogbɹɔɹsgɹæl	bogbɹɔɹskɹal
qoɹmpɸupseɹp	koɹnpfupteɹp
ɛɹsqunnɔɹp	ɛɹskʊnnɔɹp
fɹollæsɹɔɹ	fɹollasɹɔɹ
nɔdlɹɔkfip	nɔdlɹɔkfip
dɹodsnɔbnɹɛɹk	tɹodsnɔbnɹɛɹg
ɹifplɔɱfɹut	ɹɪfplɔnfɹʊt
quɹbytsnæɹs	kʊɹbɪtsnaɹs
lɹustnɛɸɶɹf	lɹʊstnɛpaɹf
bɹiɹlgɹufdɹæf	pɹiɹlkɹʊfdɹaf
bɹiɹmbɹuflɹɛɹp	pɹɪɹnbɹuflɹɛɹb
pɸuɹsnistsik	pfʊɹsnɪsttik
pɸofppɸoɹgses	pfofppfoɹgtes
sɹiɹnsiɹdnɔfp	sɹɪɹntɪɹtnɔfp
bɹɛfsæɹlqut	pɹɛfsaɹlkʊt
sɹiɹdsnudlin	sɹiɹdsnʊdlɪn
snunsfɹuɹglɹup	snunsfɹʊɹglɹub
zugzistzip	dugdistdɪb
dɹustqoɹgfɹin	tɹʊstkoɹkfɹin
nogdɹiɹgbɹɔɹ	nogtɹiɹgbɹɔɹ
pɸɛslitsiɹk	pfɛslɪtsiɹk
dægzɔpse	dagdɔpte
zinsfɹiɹbsnɔ	dinsfɹiɹbsnɔ
næɹmbɹæɹlsuɹl	naɹnpɹaɹltʊɹl
ɸɔstɢulsnip	pɔstgʊlsnip
bɹonsniɹdgɹost	bɹonsnɪɹtkɹost
tsunsgɹæɹbɸɔns	tsʊnsgɹaɹppɔns
fɹitgɹudxiɹk	fɹɪtkɹʊdkiɹg
fɹɛɹdsnudsnɔst	fɹɛɹdsnʊdsnɔst
gɹofpɸiɹfbɹiɹp	kɹofppiɹfbɹɪɹp
ɢokbɹidɹis	gokbɹɪtɹis
βøɹdɹoldæɹs	beɹtɹoldaɹs
gɹɔɹfxibnuɹt	gɹɔɹfkibnuɹt
sogtsælβol	sogtsalbol
nuŋgɹoɹfnɔns	nʊngɹoɹfnɔns
zeɹbxiɹblɹæp	deɹbkiɹplɹap
nuftsɔbsnet	nuftsɔbsnet
zufdɹɛstpɸuɹp	dʊfdɹɛstpfʊɹp
dɹjɔkdɹɛf	dɹiɔktɹɛf
ɢulzeɹmpɸɛɹf	gʊldeɹnpfɛɹf
tsustnɹɔbbɹɔf	tsustnɹɔbpɹɔf
sɹustsisɢɔs	sɹʊstsisgɔs
ɸɶɹgnuɹfpɸep	paɹknʊɹfpfep
gɹuksɔɹbɸøf	gɹʊktɔɹppef
sɔtdɹuɹgfɔɹl	tɔtdɹʊɹkfɔɹl
bɹætɸiɹsnip	bɹatpiɹsnɪb
ɣiɹsdɹeɹlfɔɹn	gɪɹsdɹeɹlfɔɹn
dɹoɹdgɹiglɹin	dɹoɹdkɹɪglɹɪn
dɹuɹgzɛɹblɹɛf	tɹuɹgdɛɹplɹɛf
lɹɔɹflɹɛɹfsut	lɹɔɹflɹɛɹfsut
finsɣifppɸeɹt	finsgɪfppfeɹd
fɔfptsɛɹlbɹuɹs	fɔfptsɛɹlbɹʊɹs
næsdɹuɹbsɹus	nastɹʊɹbsɹus
qodpɸɛdfɔɹf	kodpfɛdfɔɹf
snuɹbgɹitsɹɔl	snʊɹpgɹɪtsɹɔl
nuɹdɸɔɹdɸœp	nuɹtpɔɹdpɛp
etpydgæs	etpɪdgas
quɹslɹækdɹu	kuɹslɹakdɹʊ
fɹæɹbgɹɔŋgɹo	fɹaɹpkɹɔngɹo
qɔglɹiɹfgɹi	kɔglɹɪɹfkɹi
fɹɔɹbbɹodsɹiɹk	fɹɔɹbbɹodsɹiɹg
ziɹgtsɛɹsfins	dɪɹktsɛɹsfɪns
bɹistlɹinsɹeɹl	bɹistlɹinsɹeɹl
tsæɹbdɹɛɹgfɹi	tsaɹpdɹɛɹkfɹɪ
qɔfpdɹuɹbɹæn	kɔfpdɹuɹpɹan
fuɹltsuɹmβins	fuɹltsuɹnbins
ɸɔsneɹgbɹuk	pɔsneɹkbɹʊg
tsuɹgdɹuɹsæɹt	tsʊɹkdɹuɹsaɹd
quɹzɛɹdɸœt	kʊɹdɛɹdpɛt
suɹgsɹulzens	tuɹksɹʊldens
bɹiɹgluɹspyɹt	pɹɪɹkluɹspɪɹd
ɢonstsonlɹæp	gonstsonlɹab
fɹustdɹolfɹɛɹp	fɹʊstdɹolfɹɛɹp
sifplɹeɹsnɹep	sifplɹeɹsnɹeb
dɹettsuɹlsɹæn	dɹettsuɹlsɹan
snɛɹglæstlɹæp	snɛɹklastlɹap
dɹɛɹflɹefxiɹl	dɹɛɹflɹefkɪɹl
dɹuɹgnɹeɹbβoɹp	tɹuɹgnɹeɹbboɹb
dɹɔɱfiɹgnifp	dɹɔnfiɹknɪfp
gɹoɹdsɹifplɹɔɹ	kɹoɹdsɹifplɹɔɹ
nɔɹdsɹuɹnɹæt	nɔɹdsɹʊɹnɹad
fɹæɹsɸɶdtsuk	fɹaɹspadtsʊk
zifsifpdɹos	dɪfsifpdɹos
fæsɹoɹddɹins	fasɹoɹtdɹins
lɹoɹlbɹisbɹuɹf	lɹoɹlpɹɪsbɹʊɹf
ɣiklistzus	gɪklɪstdʊs
bɹæɹdlɛbɹop	pɹaɹtlɛpɹob
ifgɹiɹldɹɔl	ifkɹiɹltɹɔl
nɹissɛɹfsne	nɹissɛɹfsne
sɹunsgɹupsɹɛɹs	sɹʊnskɹupsɹɛɹs
sɹuɹdβoɹβœt	sɹuɹdboɹbɛt
ɹæɹgɹɔɹglɹiɹn	ɹaɹkɹɔɹglɹiɹn
fɹusɹosuɹl	fɹʊsɹotʊɹl
tseɹssoɹgɸufp	tseɹstoɹkpufp
lɹæɹbgɹoɹndɹɔɹ	lɹaɹbgɹoɹndɹɔɹ
seŋgɹɔlɸøp	tenkɹɔlpeb
bɹɛfpbɹɔsdɹiɹk	pɹɛfpbɹɔsdɹɪɹk
gɹæɹgbɹɛɹlgɹifp	gɹaɹkpɹɛɹlkɹɪfp
ɹupgɹolzut	ɹupkɹoldʊt
qutpɸuɹdsnuɹ	kʊtpfuɹdsnʊɹ
snɔsɸokfeɹs	snɔspokfeɹs
silæɹfɹɔɹt	tɪlaɹfɹɔɹd
gɹænslɹibɸɔp	kɹanslɹibpɔp
zɛlfɹipdæt	dɛlfɹɪpdat
kægpɸifxɛk	kagpfɪfkɛg
gɹisgɹɛgbɹif	kɹiskɹɛgpɹɪf
xilxitpɸot	kɪlkitpfod
dɹɛseɹmbɹæk	tɹɛseɹnpɹak
fogɹɔɹnɹeɹp	fokɹɔɹnɹeɹb
xiɹggɹɛgɸøt	kiɹkkɹɛgpet
dɹuɹdsoɹndɹes	dɹuɹdtoɹntɹes
ufsnutsoɹk	ʊfsnutsoɹk
loɹgbɹiɹndɹifp	loɹgpɹɪɹndɹɪfp
lotsiɹdqɔns	lotsɪɹtkɔns
ɹæɹgbɹɔɹgpɸæl	ɹaɹkbɹɔɹgpfal
βɔtgæsoɹl	bɔtgasoɹl
bɹægsɹiɹbsiɹt	pɹagsɹiɹpsɪɹt
nɹɛdβuɹost	nɹɛdbʊɹost
ɢumpɸiɹnnɔɹk	gʊnpfiɹnnɔɹg
βupsnæsziɹk	bʊpsnasdɪɹg
tsoɹlinnæst	tsoɹlɪnnast
tæɹgsnedgɹɛɹn	taɹgsnedkɹɛɹn
lonsɸuplɹuɹp	lonspʊplɹuɹb
sufgɹæfbɹin	tufkɹafbɹin
snensbɹɛɹddɹɔɹk	snenspɹɛɹdtɹɔɹg
xiɹfæstɣefp	kiɹfastgefp
βindɹiɹdnɹɛɹk	bindɹɪɹtnɹɛɹk
ɹɔstlæpsuɹ	ɹɔstlapsʊɹ
byɹɱfɛɹglon	bɪɹnfɛɹglon
pɸɔnssestdɹɛ	pfɔnstestdɹɛ
byɹspyɹfnɹoɹk	bɪɹspɪɹfnɹoɹk
lægdɹɛɹdɸœl	lagdɹɛɹtpɛl
nɹɔgdɹɔɹlbɹoɹl	nɹɔgtɹɔɹlbɹoɹl
fɛnslɛɹmpyf	fɛnslɛɹnpɪf
listbɹeɹflɹæɹt	lɪstbɹeɹflɹaɹd
setbɹiklæfp	setbɹiklafp
loɹɹuniɹf	loɹɹʊniɹf
niktsɛpɢost	niktsɛpgost
pɸiɹfgætnɹæns	pfɪɹfgatnɹans
ɛɹgdɹiɹgxeɹp	ɛɹktɹɪɹkkeɹp
ɸɶɹsbɹiɹdβil	paɹspɹiɹdbil
ɸɔɹnnɹɔɱfun	pɔɹnnɹɔnfun
fɹæɹgnobnuɹ	fɹaɹknobnʊɹ
feɹbsɔɹgsnɔɹn	feɹbtɔɹksnɔɹn
gɹistlɔɹfɢuns	kɹɪstlɔɹfguns
ɔɹbβogqɔɹp	ɔɹbbogkɔɹp
suɹlzɛggɹuk	suɹldɛggɹʊk
pɸæsgɹidnɔst	pfaskɹidnɔst
pɸɔdqofpɸɹɔns	pfɔdkofpfɹɔns
zigbɹæpgɹop	digbɹapkɹob
bɹoɹdɹiɹdnɹif	pɹoɹdɹɪɹtnɹif
finsbɹiɹgpɸæp	fɪnspɹiɹgpfab
noɹdbɹɔpɸæɹ	noɹdbɹɔpfaɹ
lɹisɹuttsæɹk	lɹisɹʊttsaɹk
ɸɔɹdnæsɸœp	pɔɹtnaspɛp
gɹɔpxɛfpgɹus	gɹɔpkɛfpgɹʊs
lɹodliɱfɹiɹl	lɹodlinfɹɪɹl
ziɹgsiɹggɹul	dɪɹgsiɹkgɹul
ɸigfɹiɹdlæfp	pigfɹiɹtlafp
ɹɛplustβul	ɹɛplustbul
lɹeɹdækdɹuns	lɹeɹtakdɹuns
lɹustnonsɹæɹn	lɹustnonsɹaɹn
qodsnifpsɔɹ	kodsnifptɔɹ
βiɹbyɹlgæɹp	biɹpɪɹlgaɹp
βufdɹitnɹist	buftɹɪtnɹɪst
zegɹoplek	degɹopleg
sɛɸoɹgɸuɹs	sɛpoɹgpuɹs
fɛsfɹufpdɹip	fɛsfɹufpdɹɪb
nɹiɹgɹostβɶs	nɹɪɹgɹostbas
fɹɔlfɹulnɛɹ	fɹɔlfɹulnɛɹ
lufpɸiɹbsɔɹt	lufpfiɹpsɔɹd
sɹinstsiɹgpɸæp	sɹɪnstsɪɹgpfab
nɹulziɹgsuɹk	nɹuldɪɹktuɹg
snɔkdɹæɹfbɹɔ	snɔkdɹaɹfpɹɔ
bɹɔɹɣiɹmbɹun	bɹɔɹkɪɹnbɹun
ɸœdbyɹsɸøɹt	pɛdbɪɹspeɹt
ɸubdɹoɹzust	pubtɹoɹdust
bɹuɹdbytɸus	pɹʊɹdbɪtpʊs
dɹæɹlpɸulɸɔɹk	dɹaɹlpfulpɔɹg
pɸonsnutɸœl	pfonsnʊtpɛl
dɹifɸœɹlnɹen	tɹɪfpɛɹlnɹen
gɹigɸukseɹk	kɹigpʊkseɹk
dɹeknuɹdbɹuɹk	dɹeknʊɹtbɹuɹk
βuɹblilfɹɛk	buɹblilfɹɛg
dɹɔsɔglɹɛɹk	dɹɔsɔglɹɛɹk
dɹisdæɹsbɹoɹl	dɹisdaɹsbɹoɹl
suɹlsinɹeɹt	sʊɹltɪnɹeɹt
ɸøɹdniɹdbɹist	peɹtnɪɹdbɹist
lɛstdɹɔɹbɹiɹs	lɛsttɹɔɹpɹɪɹs
afnɹæɹbɣist	afnɹaɹbgist
dɹɛɹffændɹɔt	dɹɛɹffantɹɔd
lɹuɹdsuɹsgɹun	lɹuɹdtuɹskɹun
nɛɹgbɹælpɸuɹk	nɛɹkbɹalpfuɹg
nɹensɹuɹnliɹk	nɹensɹuɹnlɪɹg
zɛlqɔɹssɹeɹk	dɛlkɔɹssɹeɹg
βøɹdtsɛɹmbɹi	beɹdtsɛɹnbɹi
ɣiɹstsiɹot	gɪɹstsɪɹot
βoɹdgɹotsɹis	boɹtgɹotsɹɪs
tsuɹsnuɹdtsul	tsuɹsnʊɹttsul
nuɹgqoltsip	nuɹkkoltsib
zuɹdfɹukɣɛp	duɹtfɹʊkgɛp
fɹiɹmpɸæstsɹuɹp	fɹiɹnpfastsɹʊɹp
nɹɔɹsɹɛɹflu	nɹɔɹsɹɛɹflu
suɹdpɸuɹddɹæst	suɹdpfuɹddɹast
sifpɸɔɹgsɹæp	sifpfɔɹksɹap
bɹɛgludsuɹ	bɹɛgludtʊɹ
zeɹfpɸidɸuɹk	deɹfpfidpuɹk
ɸostnɹotliɹs	postnɹotliɹs
fɹɔlɹɛɹdfɹæɹl	fɹɔlɹɛɹtfɹaɹl
fɛsnɹiɹndɹiɹ	fɛsnɹɪɹndɹɪɹ
nɹeɹsdɹætnik	nɹeɹsdɹatnig
gɹɔstgɹinsut	gɹɔstkɹintʊd
xitnɹulfɹuɹp	kɪtnɹʊlfɹʊɹp
gɹiɹmɸuttsust	gɹɪɹnputtsʊst
qɔgɹunnɹuɹf	kɔkɹunnɹʊɹf
snustgɹæfsɹip	snustgɹafsɹip
seɹɣegfifp	seɹgegfifp
niɹllɹuɹbɹup	nɪɹllɹʊɹpɹʊb
βifpdɹæbfɹup	bifptɹabfɹub
sniɹbɹuɹdfɹek	snɪɹbɹuɹdfɹeg
nɹoɹgɹollɹik	nɹoɹgɹollɹig
gɹæɹddɹeɹfsut	gɹaɹttɹeɹftʊd
dɹɔɹgzɛɹlzɔ	dɹɔɹgdɛɹldɔ
fæpbɹistsɹɔk	fappɹistsɹɔg
xinsuɹdbɹuɹp	kɪnsʊɹtpɹʊɹb
gɹɔnɹæɹfɸuk	gɹɔnɹaɹfpʊg
fɹæɹzoɹntæɹp	fɹaɹdoɹntaɹp
sistxiɹlleɹs	sistkɪɹlleɹs
xefɹiɹdluɹk	kefɹiɹdlʊɹg
sensɹɔstβiɹt	sensɹɔstbiɹt
fɹesbɹætzust	fɹesbɹatdʊst
nuɹdtsuɹɢup	nʊɹttsʊɹgup
ɣinsnɹɛɹdbɹet	gɪnsnɹɛɹdbɹed
gɹukæstdɹep	kɹukastdɹep
siɹblɹubnɹɛɹf	sɪɹblɹubnɹɛɹf
dɹæɹbfɹæpnok	tɹaɹpfɹapnok
pɸɔɹbfɹetdɹiɹl	pfɔɹbfɹettɹɪɹl
zudgɹuɹffɹɔk	dʊdkɹʊɹffɹɔg
nɹæɹβidsnɔɹl	nɹaɹpidsnɔɹl
pɸeɹdɹiɹbfɹok	pfeɹdɹiɹbfɹog
nɛɹɣeɹlpɸæɹp	nɛɹgeɹlpfaɹb
bɹæɹdfɹɛɹgqoɹp	pɹaɹdfɹɛɹkkoɹp
setfutfest	tetfʊtfest
gɹɔɹbbɹɔnzɛɹl	kɹɔɹppɹɔndɛɹl
bɹɔffæɹlfɹifp	bɹɔffaɹlfɹifp
gɹidpyɹgɹɔt	kɹɪdpɪɹkɹɔt
ɸuɹfbɹɔɹdbɹuɹk	pʊɹfbɹɔɹtbɹuɹg
liɹsɸiɹɹɛf	liɹspiɹɹɛf
bɹɔɹdqulsus	pɹɔɹdkʊltʊs
dɹɔɹziɹdɸoɹs	tɹɔɹdiɹdpoɹs
fɔsgɹɔpdɹif	fɔskɹɔpdɹif
sunsgɹusnuns	sunskɹʊsnʊns
ɸɔgfɹoqust	pɔgfɹokust
bɹɛfplodlɹæfp	pɹɛfplodlɹafp
festdɹiɹgbɹik	festdɹiɹgbɹik
zuɹdɹɛɹgɸuɹn	dʊɹtɹɛɹkpuɹn
suɹgnɹeɹdɹiɹk	tʊɹknɹeɹtɹɪɹk
bɹestdæɹdsɹiɹs	bɹestdaɹdsɹiɹs
ɣeɹgsɹuɹfkæf	geɹksɹʊɹfkaf
nɹeɹgsifbɹok	nɹeɹksɪfbɹog
byɹfɸotdɹɛt	bɪɹfpotdɹɛd
bɹipbɹeŋgɹɛn	pɹɪpbɹenkɹɛn
ɣiɹbzɛsiɹl	giɹpdɛtɪɹl
fifɸopnɹɔf	fifpopnɹɔf
snɛfplɹiɸœt	snɛfplɹɪpɛt
ɣiɹglɹɔɹβɶns	gɪɹglɹɔɹbans
snɔɹgɹɛnsxiɹf	snɔɹgɹɛnskiɹf
zulɹɔɹnsɹef	dulɹɔɹnsɹef
snuɹbgɹiɹdsnok	snuɹbkɹiɹtsnog
dɹæfeɹfɣiɹt	dɹafeɹfgɪɹt
nupnɹiɹɣiɹn	nʊpnɹiɹkɪɹn
dɹibbɹiɹbxef	tɹɪbpɹiɹbkef
pɸæɹfɛlun	pfaɹfɛlʊn
sɹɔtpɸuŋxit	sɹɔtpfunkɪd
dɹɛɹbgɹoɹgɸøɹn	tɹɛɹbgɹoɹkpeɹn
bɹɛɹsnɛfnut	bɹɛɹsnɛfnut
ɢuɹglæggɹost	guɹklaggɹost
dɹusɣɛlziɹp	tɹʊsgɛldɪɹp
ɹefpnɹistsɛɹs	ɹefpnɹɪstsɛɹs
lɹiɹdgɹonnɹi	lɹɪɹdkɹonnɹi
pɸuɹgpɸeɹlit	pfuɹgpfeɹlid
bɹænsgɹælgɹif	bɹansgɹalgɹif
pɸisttsælɛɹs	pfɪsttsalɛɹs
nɔtdɹæɹbβuk	nɔtdɹaɹbbuk
lɹulbɹuɹbnɹɛst	lɹulbɹuɹbnɹɛst
nɹɛɹbsnupbɹɛs	nɹɛɹbsnʊpbɹɛs
gɹuɹbzuɹfdɹiɹf	gɹuɹbdʊɹfdɹɪɹf
lɹufpsɔɹgbɹoɹk	lɹufptɔɹgbɹoɹk
nɔɹlbɹesgɹoɹl	nɔɹlpɹeskɹoɹl
tsædɹiɹgsɹæɹf	tsadɹiɹksɹaɹf
nɹignitdɹɔɹt	nɹignɪtdɹɔɹt
fufsɔbɹuk	fufsɔpɹʊg
nɹipgɹoɹlæk	nɹipkɹoɹlak
dɹæɹdgɹɛnsnɹæf	tɹaɹdgɹɛnsnɹaf
tsifpɸæɹssuɹt	tsɪfpfaɹssʊɹd
uɹgsɹɛɹgsos	ʊɹgsɹɛɹgsos
lɹubgɹæɹbdɹɛp	lɹʊbgɹaɹbdɹɛb
bɹifpβuftsuɹt	pɹɪfpbʊftsʊɹd
bɹɔbseɹblɔk	bɹɔbteɹblɔk
nuɹdbɹɛnsɹik	nuɹtbɹɛnsɹɪg
bɹegɹuɹbzɔɹn	bɹekɹuɹpdɔɹn
ɣisfɹutdɹeɹs	gisfɹuttɹeɹs
qoxiɹgdɹe	kokɪɹgtɹe
sugdɹɔkbɹis	sugtɹɔkbɹis
dɹiɹnsnɛɹbbɹɔt	tɹɪɹnsnɛɹppɹɔt
ɢoɹssnuɹlqɔt	goɹssnʊɹlkɔt
tsæbfɹogsnɔɹf	tsabfɹogsnɔɹf
fustfiddɹut	fʊstfiddɹʊt
ɔɹdgɹæstbɹuk	ɔɹtkɹastbɹʊg
tseɹsɢubβil	tseɹsgʊbbil
sondɹufpqɔp	tondɹʊfpkɔb
gɹuɹblustlæk	gɹuɹblustlag
dɹelbɹæɹbɹiɹk	dɹelbɹaɹbɹiɹg
ɹubtsuɹlsoɹp	ɹubtsuɹltoɹp
nɹeɹlsɛfpsɹoɹk	nɹeɹltɛfpsɹoɹg
fɹenssɹubɹɔɹl	fɹenssɹʊbɹɔɹl
pɸæffɔlnil	pfaffɔlnil
lɛnseɹsuɹn	lɛnseɹsuɹn
gɹogfɹojɹl	gɹogfɹoɪɹl
lɹɔɹnsɹɛɹbɹust	lɹɔɹnsɹɛɹbɹust
dɹestgæplɹiɹs	dɹestgaplɹɪɹs
sɹipɸispɸel	sɹɪpfispfel
qusgɹɔdbɹuɹk	kuskɹɔdpɹuɹg
zistsitbɹɔk	distsɪtbɹɔk
ɔkɸœdsɛk	ɔkpɛdsɛk
ɣeɹglɹɛɹdzɔɹf	geɹklɹɛɹddɔɹf
zɔbgɹefβuɹt	dɔbgɹefbʊɹt
lɛnstsiɹbgɹe	lɛnstsɪɹbgɹe
fɹɛflukgɹɛɹp	fɹɛflukkɹɛɹb
supɸɔtɸoɹf	tupfɔtpoɹf
gɹɔɹgsnuplust	kɹɔɹgsnʊplʊst
sɛsæpni	tɛsapnɪ
bɹɛpbɹɔglɔf	bɹɛpbɹɔglɔf
fegdɹælɹuɹl	fegdɹalɹuɹl
bɹæffɹillɹifp	bɹaffɹillɹɪfp
snɔɹblidnil	snɔɹplɪdnil
sɔtdɹigbɹefp	sɔttɹigbɹefp
sɔsoɹbdɹɛt	sɔsoɹptɹɛt
bɹonsɹɔstnuɹk	pɹonsɹɔstnuɹg
nɹoɹdbɹedpɸi	nɹoɹtpɹedpfɪ
sɹiɹbsisbɹɛn	sɹɪɹpsɪspɹɛn
sniqoɹsnɹiɹp	snɪkoɹsnɹɪɹp
dæbβøɹβœst	dabbeɹbɛst
ɹolɛɹssop	ɹolɛɹssob
pɸeɹdlɹɔgdɹik	pfeɹtlɹɔgtɹɪg
snɛɹlsnɔɹllil	snɛɹlsnɔɹllil
nɹæɹgsɔfpsniɹt	nɹaɹksɔfpsnɪɹd
kæɹbβøtsok	kaɹpbetsok
fɹɔɹgxiɹftsiɹp	fɹɔɹkkɪɹftsɪɹb
gɹupkæɹbgɹɛɹt	gɹʊpkaɹpkɹɛɹt
dɹɛɹsdɹɛfplæɹl	tɹɛɹsdɹɛfplaɹl
fɹɔpɸoldɹeɹt	fɹɔppoldɹeɹd
bɹæktsæɹgsiɹl	pɹaktsaɹgsiɹl
siɹbbɹosnɔst	siɹpbɹosnɔst
gɹeɹβoɹfɹin	gɹeɹboɹfɹin
βoɹdsnekbɹuɹk	boɹtsnekbɹuɹg
gɹutsnesgɹol	gɹutsnesgɹol
fegɹistgɹɛk	fegɹistgɹɛg
bɹegsɹæpɢut	pɹegsɹapgud
niɹfsiɹndæɹf	niɹftɪɹndaɹf
gɹɛpsuɹŋgɹen	gɹɛpsuɹngɹen
pɸɛɹfɸɔɹgɣest	pfɛɹfpɔɹkgest
nɛssiplɹiɹt	nɛstiplɹɪɹd
gɹuɹffɛstzot	kɹʊɹffɛstdot
sɹiɹgbɹebquɹk	sɹiɹkbɹebkuɹk
ɸostgɹɛfdɹol	postkɹɛfdɹol
ɹoɹldɹuɹdnæɹk	ɹoɹldɹuɹdnaɹg
nɹæɹbfɹɔfsɹiɹk	nɹaɹpfɹɔfsɹiɹk
bɹiɹgfɹɔɹlgɹek	pɹɪɹkfɹɔɹlkɹeg
qoɹdɸiddɹɛɹk	koɹdpidtɹɛɹg
βɶɹffɹestβɶ	baɹffɹestba
βɶnsɹeɹsfist	bansɹeɹsfɪst
gɹefpɸoɹsfon	kɹefppoɹsfon
ɣikβœgɹiɹk	gɪkbɛkɹɪɹk
gɹifpɸensɔɹp	kɹɪfpfensɔɹb
tæɹssɹuɹgfɛt	taɹssɹʊɹgfɛd
qobpɸɔnsqons	kobpfɔnskons
nɹɔtdɹuɹnsof	nɹɔtdɹʊɹntof
gɹɔppyŋgæt	kɹɔppɪngat
sɹuɹlɹomɸøf	sɹʊɹlɹonpef
selzustpɸit	seldʊstpfɪt
dɹikgɹɛsuns	dɹɪkgɹɛsʊns
uɹdsoɹbfæɹk	ʊɹtsoɹbfaɹg
ɹiɹfsipnɹɛfp	ɹɪɹfsɪpnɹɛfp
bɹæpseɹfneɹt	pɹapteɹfneɹt
tsɛfɣifɹɔɹf	tsɛfgɪfɹɔɹf
snopquɱfɹɔk	snopkʊnfɹɔg
nɹɛfɹeɹdɹe	nɹɛfɹeɹdɹe
xɛgdæɹnɹus	kɛgdaɹnɹus
bɹɔɹsnɹæfpɸɹil	bɹɔɹsnɹafpfɹil
dɹotsuksnip	tɹotsʊksnib
sɹuɹbfæɹgzofp	sɹuɹpfaɹkdofp
ɸitfupkæɹt	pitfupkaɹt
sæssisgɹeɹ	sassisgɹeɹ
ɸoɹfgɹɛlzɛɹf	poɹfgɹɛldɛɹf
leltæɹbbɹoɹk	leltaɹppɹoɹg
siɹdbɹɔtlæɹn	tɪɹdpɹɔtlaɹn
pɸutseɹgβøɹk	pfʊtteɹkbeɹg
nɹulɹɛɹbzuɹl	nɹʊlɹɛɹbduɹl
fiɹgfɹɔfpsɹip	fiɹgfɹɔfpsɹib
sɛsdɹitfuɹk	tɛstɹɪtfʊɹk
bɹiɹbɹoɹnsɹiɹt	pɹiɹbɹoɹnsɹiɹt
fuɹspɸebloɹp	fʊɹspfebloɹb
dɹebpɸobtsip	tɹebpfobtsib
zuɹβɶɹdbɹik	dʊɹbaɹtbɹig
læɹglɹɛɹnsnɔp	laɹglɹɛɹnsnɔb
læɹbɹiɹliɹt	laɹbɹiɹliɹt
næɹlɹɔɹsnɛɹt	naɹlɹɔɹsnɛɹd
lisneɹfβuɹl	lisneɹfbuɹl
gɹuɹgpɸɔɹgɸop	kɹuɹkpfɔɹkpop
fupsniɹluɹl	fʊpsnɪɹluɹl
pɸoklosfons	pfoklosfons
qufβœgniɹ	kʊfbɛgnɪɹ
pɸuglɔɹbɹæɹk	pfuglɔɹpɹaɹk
nuɹdnɔlfɹɛɹt	nuɹtnɔlfɹɛɹt
fɔɹlbɹæŋgɹins	fɔɹlpɹankɹɪns
lɹibtsɔɹdnɹep	lɹibtsɔɹtnɹeb
niɹdgæɹdɣek	niɹtgaɹtgek
lɹɔɹdnɹæɹbxeɹt	lɹɔɹtnɹaɹpkeɹt
dɹæɹbfɛɹŋɢufp	dɹaɹpfɛɹngufp
gɹɔɹdzonuɹ	kɹɔɹddonuɹ
lɹɛnsgɹolniɹt	lɹɛnskɹolnɪɹd
gɹɛŋgɹɛktsiɹn	kɹɛnkɹɛktsɪɹn
ɸœɢɔstɢɔf	pɛgɔstgɔf
bɹonæɹldɹu	bɹonaɹltɹu
ɹonsnɹeɹgpɸufp	ɹonsnɹeɹgpfʊfp
sɛɹgɹuɹfnɹuk	sɛɹgɹʊɹfnɹʊg
tsigsɹidfɛp	tsɪgsɹidfɛp
ɸifxinssɹiɹf	pifkinssɹiɹf
gɹektsɛɹsfɹæɹf	kɹektsɛɹsfɹaɹf
suɹlgɹuɹdsnuɹf	sʊɹlgɹuɹdsnuɹf
fiɹfzuɹlxiɹk	fɪɹfduɹlkɪɹk
bɹuɹbkægpɸæɹ	pɹuɹpkagpfaɹ
soɹbsɛɹlβɶt	soɹbtɛɹlbat
fiɹlbɹɔɹgsuɹ	fiɹlpɹɔɹgtʊɹ
zɔdɹuɹblɹɛɹk	dɔtɹʊɹplɹɛɹg
snimβusfɹifp	snɪnbʊsfɹifp
fɹelsnustnɹiɹt	fɹelsnustnɹiɹt
nɹebɣɛnslɹɔɹl	nɹebgɛnslɹɔɹl
nɹislɹɔɹnɹiɹf	nɹɪslɹɔɹnɹiɹf
gɹɛsɣeɹldɹut	kɹɛsgeɹltɹʊd
fɹɛɹdbɹiɹntsæt	fɹɛɹdbɹiɹntsat
sniɹsɢɔɹdsæɹt	sniɹsgɔɹtsaɹt
bɹɛstdɹifbɹuɹp	bɹɛstdɹifbɹuɹp
dɹostliɹdlens	dɹostliɹtlens
lɹɔstdækɢɔl	lɹɔstdakgɔl
gɹufpβœbsnæɹl	gɹufpbɛbsnaɹl
fɹistpɸofgɹuɹt	fɹistpfofgɹʊɹd
nɔɹbxiluɹk	nɔɹbkilʊɹg
loɹsnɹidɹit	loɹsnɹɪdɹɪt
dɹɔstsɹesfiɹt	dɹɔstsɹesfiɹd
βɔɹbsnɛŋgɹins	bɔɹbsnɛnkɹɪns
fɹiɹnsɹinssnɛp	fɹiɹnsɹɪnssnɛb
βœɹfpɸɔɹdɣeɹ	bɛɹfpfɔɹtgeɹ
tsetneɹbnɹifp	tsetneɹbnɹɪfp
suɹssɛɹbgɹen	tʊɹstɛɹbgɹen
bɹækfæsok	bɹakfasok
fiɸinsnɛp	fipinsnɛb
nɹiɹgdɹiɹdɢɔ	nɹiɹktɹɪɹtgɔ
gɹodɹoɹfɢɔp	kɹodɹoɹfgɔp
loɹdlɔɹŋgɹun	loɹtlɔɹngɹʊn
ɸoɹsɹuɹgɹip	poɹsɹuɹgɹɪp
ɸiɹzostgɹep	piɹtostgɹeb
fiɹbpɸunɹɔs	fiɹppfʊnɹɔs
snuɹgzɔɹbɸuɹp	snuɹgdɔɹppuɹb
βœsdɹiɹdxil	bɛsdɹɪɹdkɪl
dɹɛstlitβɶst	tɹɛstlɪtbast
ɹɔfusgɹi	ɹɔfusgɹɪ
dɹufplelɹuɹp	dɹufplelɹʊɹp
ɣilquɹnsniɹn	gilkuɹnsnɪɹn
bɹunsdɹilfɹuɹk	pɹʊnsdɹɪlfɹʊɹk
zipbɹiɹgfif	dipbɹɪɹkfɪf
βøɹɛɹbfɹik	beɹɛɹbfɹɪg
tæspɸunsɹa	taspfʊnsɹa
tsɛbzɔstsiɹl	tsɛbdɔsttɪɹl
zuxeɹldɹæɹk	dukeɹldɹaɹk
fɹɛgbɹistfɹæp	fɹɛgbɹistfɹab
gɹufifpnɹæɹ	gɹufɪfpnɹaɹ
βoɹbxiɹdfɹop	boɹbkɪɹdfɹop
ɹɔsdɹiɹgdɹik	ɹɔstɹɪɹgtɹɪk
gɹædɹekgɹiɹt	gɹatɹekkɹɪɹt
dɹæpɢɔssɹip	dɹapgɔssɹɪp
xeqoɹdbɹuɹl	kekoɹtbɹʊɹl
bɹuɹggɹissnɛst	bɹʊɹkkɹɪssnɛst
sɹuɹbbɹigβɶɹn	sɹuɹppɹigbaɹn
sɹuɹgnɹuniɹs	sɹʊɹgnɹʊniɹs
pɸoɹnuɹdgɹen	pfoɹnʊɹdgɹen
ɹupziɹbfot	ɹupdiɹbfot
sɹuzuɹbgɹɔst	sɹʊdʊɹpgɹɔst
udbɹofpsæɹn	ʊdpɹofpsaɹn
bɹæɹdzofɹoɹt	pɹaɹddofɹoɹd
bɹupɣeɹgsis	bɹupgeɹgsis
gɹædɹæɹsdɹɔt	kɹadɹaɹsdɹɔd
suɹdfæbɸœɹt	tuɹtfabpɛɹd
dɹæɹbfifsuf	dɹaɹbfɪfsʊf
gɹesbɹudfɹoɹk	gɹespɹudfɹoɹk
dɹoɹgnoɹdbyst	dɹoɹgnoɹdbɪst
gɹinsgɹɛstnel	kɹɪnskɹɛstnel
fɹæɹbqɔgsnɔɹk	fɹaɹbkɔgsnɔɹg
fumbɹɔfpnɛst	fʊnpɹɔfpnɛst
bɹɛbpɸiɹbgɹa	bɹɛbpfiɹpgɹa
nɹustfupbɹok	nɹustfuppɹog
foɹggɹuɹdtsɛk	foɹkgɹʊɹttsɛg
sniɹbnɹoɹsnɹiɹf	sniɹbnɹoɹsnɹiɹf
lɹinsɛfpɸik	lɹɪnsɛfpfig
sɔnnugɹoɹp	tɔnnʊkɹoɹb
sɹɔssiɹggɹun	sɹɔstiɹkgɹʊn
sɹɛɹfsnelxeɹk	sɹɛɹfsnelkeɹg
bɹæfpseɹbfɹut	pɹafpteɹbfɹʊd
dɹuɹfsɹufplɔk	tɹʊɹfsɹufplɔg
nɔnsæɹnɹiɹl	nɔnsaɹnɹiɹl
næbsɹɛsɸøɹt	nabsɹɛspeɹd
gɹofpɸɹilsɛl	kɹofpfɹɪltɛl
nɹɔɹgtsɛɹsɢol	nɹɔɹgtsɛɹsgol
lidbɹiɹbgæɹt	lɪdbɹiɹbgaɹd
dæɹgpɸæɹsa	daɹkpfaɹsa
snuffɹɔɹdgɹis	snuffɹɔɹdgɹɪs
quɹŋɢuɹgbɹiɹn	kʊɹnguɹgbɹɪɹn
sistfɔqoɹ	tistfɔkoɹ
snuɹsbɹubtson	snʊɹsbɹʊbtson
bɹɔɹsdɹufpɸoɹk	bɹɔɹstɹufppoɹk
gɹɛfɸɔɹnsuk	gɹɛfpɔɹntʊg
bɹɛnsɛstbɹɛɹp	pɹɛnsɛstbɹɛɹb
dɹɛɹdsiɹdsæn	dɹɛɹttiɹdsan
lɹæpɸɹiɹdnɹɛɹt	lɹapfɹɪɹtnɹɛɹd
aɹbtæɹgɢɔt	aɹbtaɹkgɔt
nɹoɹlgɹigɹist	nɹoɹlgɹɪkɹɪst
bɹiɹniɹgɹæns	pɹiɹniɹkɹans
seɹbdɹɔɹssi	seɹptɹɔɹsti
bɹɛɹdɹidɢɔs	pɹɛɹtɹɪdgɔs
gɹɛlβɔnnɹɔns	gɹɛlbɔnnɹɔns
læɹdfɹɛtzest	laɹdfɹɛtdest
bɹisliɹbβɶ	bɹisliɹbba
luɹŋɣɛɹmbɹuɹs	lʊɹngɛɹnbɹuɹs
eslɛdtsæp	eslɛdtsap
gɹegbyɹdloɹt	gɹegbɪɹdloɹd
lifplupdæst	lɪfplʊpdast
dæɹdxinsɸuɹt	daɹtkinspʊɹt
gɹufɹæɹlɹuk	kɹufɹaɹlɹʊg
sæɹnænssɔk	saɹnanssɔg
gædbɹogpɸɛɹk	gadbɹogpfɛɹg
gæɹbɸɶɹæɹp	gaɹppaɹaɹb
snuɹbɣɛɹgluɹs	snʊɹpgɛɹkluɹs
lɹefsnɔspɸɛ	lɹefsnɔspfɛ
ɸɶɹfɣeɹdfiɹt	paɹfgeɹdfiɹt
siɹllɹotsnof	siɹllɹotsnof
gɹisdæɹfbɹɛk	gɹɪsdaɹfpɹɛk
tsoɹsβuɹlnæf	tsoɹsbʊɹlnaf
dɹɔnsfɹuplɹoɹf	tɹɔnsfɹuplɹoɹf
ɹigfuɹgnɹɔ	ɹigfʊɹgnɹɔ
sɹitfɹæɹsdɹo	sɹɪtfɹaɹstɹo
sɹiɹlzoɹldɹol	sɹiɹldoɹldɹol
xɛɹgɣiɹfsins	kɛɹggiɹftɪns
qɔɹgɹɔɹgsuɹt	kɔɹgɹɔɹktʊɹd
sodnɹiɹggɹɔk	todnɹiɹgkɹɔk
gɹɔkgɹuɹbnɹiɹs	gɹɔkkɹʊɹbnɹɪɹs
fɹifnændɹik	fɹɪfnantɹɪk
bɹuggɹæɹdsnɛt	pɹʊgkɹaɹdsnɛd
ɣiszeɹnsnut	gɪsdeɹnsnut
tsiɹsbydfɛɹk	tsɪɹsbɪdfɛɹk
gɹɔkdɹofpnɹut	kɹɔktɹofpnɹʊd
luɹzudsɹef	lʊɹtudsɹef
bɹuggɹæstpɸo	pɹuggɹastpfo
ziɹdɸoɹslɹik	dɪɹdpoɹslɹig
zoɹgdɹiɹbɹeɹp	doɹgtɹiɹbɹeɹb
pɸæɹgsɔsik	pfaɹgsɔsik
nifɛtpɸɛɹp	nɪfɛtpfɛɹp
ɸɶɹsnugæɹp	paɹsnugaɹp
gɹækgɹæɹfsɹof	gɹakkɹaɹfsɹof
snigdɹifi	snigtɹɪfɪ
liɹdɸustziɹt	lɪɹtpʊstdiɹt
ɹizinsfɹiɹn	ɹɪdɪnsfɹɪɹn
zitgɹoɹgpɸɛɹk	ditgɹoɹgpfɛɹg
ɣɛpɸebɹit	gɛpfebɹɪd
ɸɶɹgbyɹlzɔst	paɹkbɪɹldɔst
ɹæɹstsuɹnsu	ɹaɹstsuɹntʊ
fugɹedɹɔɹt	fʊkɹetɹɔɹd
βustzulnɹif	bʊstdulnɹɪf
ɸubɹugsɹæɹt	pʊbɹugsɹaɹd
gɹɔdluɹglɹust	kɹɔdluɹklɹʊst
ɹesgɹɔmbɹɛɹs	ɹesgɹɔnpɹɛɹs
neɹsbɹoɹlbɹiɹt	neɹsbɹoɹlpɹɪɹd
ɸinsdɹiɹntsuɹn	pinstɹiɹntsuɹn
gɹokfɹiɹfqo	kɹokfɹɪɹfko
gɹugɹiɹnsniɹk	gɹukɹiɹnsniɹg
oɹsqupɸɹɛs	oɹskupfɹɛs
lɹilqobyɹf	lɹɪlkobɪɹf
lɛbɹetqut	lɛpɹetkut
βukgɹɛɹsɸɔk	bʊkkɹɛɹspɔg
gɹiftsifɛɹk	gɹɪftsifɛɹg
fɹognɛdpɸɔt	fɹognɛdpfɔd
dɹɔdnɹiɹbɹɔ	tɹɔdnɹɪɹbɹɔ
sɹæblɹeɹdlɔns	sɹablɹeɹtlɔns
sɔɹlxiflik	sɔɹlkiflɪg
βɔdsɹunzil	bɔdsɹʊndil
sɹetβuɹfdæp	sɹetbuɹfdab
bɹeɹnnɹɔdɹæɹk	bɹeɹnnɹɔtɹaɹg
sɹɔssɔɹdsnep	sɹɔstɔɹtsnep
niɹfzigsɹɔɹk	nɪɹfdɪgsɹɔɹg
xɛnsnuɹddɹɛɹn	kɛnsnuɹddɹɛɹn
dɹinsbɹeɹfnɹiɹs	tɹinspɹeɹfnɹɪɹs
ɢufqoɹfgɹif	gʊfkoɹfgɹɪf
sofbɹunsiɹl	sofbɹunsiɹl
ɹɔnslɹuɹdsist	ɹɔnslɹuɹtsɪst
sɛnsɔnsfɔp	tɛntɔnsfɔp
lɛstneɹgsɹip	lɛstneɹksɹɪp
sunszɛktsup	sunsdɛktsʊb
tsesgɹætsɹuk	tseskɹatsɹʊk
snædɹuŋquɹp	snadɹʊnkuɹp
fepɣeɹgsuɹl	fepgeɹksʊɹl
ɹoɹdqulsæɹ	ɹoɹtkulsaɹ
lɹuglɹuɹsfoɹl	lɹʊglɹuɹsfoɹl
liɹfɛbliɹs	liɹfɛbliɹs
sninlɹæstfɔt	snɪnlɹastfɔt
lelpɸiɹbsɹiɹt	lelpfiɹbsɹɪɹt
qopbɹeseɹn	koppɹeteɹn
qoɹuɹbbɹeɹt	koɹʊɹbpɹeɹt
aɹdgɹɛbɹoɹk	aɹtkɹɛpɹoɹg
lofxɛɹltsæɹk	lofkɛɹltsaɹk
sɹipypdɹop	sɹɪpɪptɹob
dɹɛɹsbɹɔkbɹup	tɹɛɹsbɹɔkbɹub
xeɹlɸɔkgɹit	keɹlpɔkgɹit
sipɸelsnɔɹt	sɪpfelsnɔɹt
gɹoɹdβotsin	gɹoɹtbotsin
sɹuɹbdɹiɹbɢɔɹt	sɹʊɹpdɹɪɹpgɔɹd
ɹɔɹdlɹuttsɛɹ	ɹɔɹdlɹʊttsɛɹ
bɹefsɹɔpsnɛ	pɹefsɹɔpsnɛ
logɹellɹæst	lokɹellɹast
lufpsɹuɹsnol	lʊfpsɹʊɹsnol
snɛfkæɹgɹus	snɛfkaɹkɹʊs
gɹuɹbɢotsɔt	gɹuɹpgotsɔt
gɹendɹɔɹŋɢoɹn	gɹentɹɔɹngoɹn
loɹbnɹusbɹæɹn	loɹbnɹuspɹaɹn
fosdɹiɹnæst	fostɹɪɹnast
kæfiɹfzɔf	kafɪɹfdɔf
ɣifpbɹɔɹsɔfp	gɪfppɹɔɹsɔfp
oɹspymβut	oɹspɪnbut
ɹæɹfnɹætfɹuɹk	ɹaɹfnɹatfɹuɹg
nɹokneggæk	nɹokneggag
sniɹfɹuɹgɢuɹp	sniɹfɹʊɹkguɹb
gɹufpzoslɛɹf	kɹʊfpdoslɛɹf
sɛɹbpɸɔfpbɹɛɹk	sɛɹppfɔfpbɹɛɹg
pɸiɹβunssuɹl	pfiɹpʊnstuɹl
zɔɹfɸustsɹiɹt	dɔɹfpʊstsɹɪɹd
lɔggɹiɹsufp	lɔggɹɪɹsʊfp
fɹæɹbdɹuɹfɸøp	fɹaɹptɹuɹfpeb
ɣinsnɹubɹuɹp	ginsnɹʊbɹuɹp
ɹidsɹɛɹbbɹɛɹp	ɹidsɹɛɹpbɹɛɹb
xɛstlɹuɹspɸɔt	kɛstlɹʊɹspfɔt
pɸɛtdɹɛnle	pfɛtdɹɛnle
qɔɹfɣitgɹip	kɔɹfgɪtkɹib
xiggɹipdɹɔt	kigkɹipdɹɔt
siɹfɣestpɸæɹf	tɪɹfgestpfaɹf
qupquɹdnɹɔn	kupkʊɹdnɹɔn
dɹugseddɹɛl	tɹʊgseddɹɛl
nɹælbɹɛɹffɔɹp	nɹalbɹɛɹffɔɹb
qokpɸoɹnup	kokpfoɹnub
zotfɹuɹlnist	dotfɹuɹlnist
pɸæɹbsɹenstsæst	pfaɹpsɹenstsast
xiɹgnufsɹuk	kɪɹknʊfsɹug
ɣifsɹotdɹuɹ	gɪfsɹotdɹuɹ
gɹitβɔldɹæɹk	gɹitbɔldɹaɹg
snossuksɹɛk	snostuksɹɛg
fæklɹogɹɛɹf	faklɹokɹɛɹf
ɹunssustnuf	ɹʊnssustnuf
sæɹbgɹissik	saɹpkɹistik
pyfpgɹubɸøt	pɪfpkɹʊbped
seddɹoɹfpɸut	seddɹoɹfpfut
obɹuɹfgɹæt	obɹuɹfkɹad
lɔɹgpɸæfptsæɹt	lɔɹkpfafptsaɹd
nɹinsɛtpyɹt	nɹintɛtpɪɹd
bɹudpɸiɹmβiɹf	bɹʊdpfɪɹnbiɹf
sɹoŋgɹɛɹfis	sɹongɹɛɹfɪs
iɹbgɹɛnsoɹt	iɹpkɹɛnsoɹd
dɹiɹlkæɹɱfɹep	dɹɪɹlkaɹnfɹep
pɸegpɸɛɹbpyɹn	pfegpfɛɹbpɪɹn
sefquɹsfɔɹ	tefkuɹsfɔɹ
fobsiɹgsik	fobtɪɹksig
lempɸækzut	lenpfakdʊt
qunsiɹgqot	kunsɪɹgkot
oɹbzɛɹbβust	oɹbdɛɹbbʊst
tsiɹdsotpɸip	tsɪɹdtotpfɪp
gɹetpɸɛnsost	gɹetpfɛnsost
zuɹŋɣɛɹlsɛɹt	dʊɹngɛɹltɛɹd
ziɹɛfgɹuk	dɪɹɛfgɹʊk
sɔbdɹiɹbfɹup	tɔbtɹiɹpfɹʊb
sɔnssɔɹbgɹɔf	tɔnstɔɹpkɹɔf
ɸuɹbɹeɹdfiɹp	puɹpɹeɹtfiɹp
tsæflɹuflɛs	tsaflɹʊflɛs
seɹdɸugsɹus	seɹdpugsɹʊs
xegpɸustzɛɹp	kegpfʊstdɛɹp
tsiɹdnosttsin	tsɪɹtnosttsin
agsoɹlpɸiɹf	agtoɹlpfiɹf
bɹipzɔtseɹp	pɹɪpdɔtteɹp
gɹoɹlleŋgɹet	gɹoɹllengɹed
bɹægzofsost	bɹagdofsost
ɹodɢɔgɹæk	ɹodgɔgɹak
ɣistsodnop	gistsodnob
fifpβɔɹgdɹeɹp	fifpbɔɹkdɹeɹb
fɹæɹglustnɹɛɹ	fɹaɹklʊstnɹɛɹ
segsnunsɹɛɹl	tegsnʊnsɹɛɹl
ɹitæsfip	ɹɪtasfɪp
snofgɹiɹlsɹuf	snofgɹɪɹlsɹuf
fɹeɹbfuɹbgɹuɹp	fɹeɹbfʊɹpgɹuɹb
zɛɹgpɸɔspɸoɹp	dɛɹgpfɔspfoɹb
lɹiɹfzuɹbtsæɹp	lɹɪɹfduɹptsaɹp
lɹɛɹβiɹgæɹk	lɹɛɹpiɹkaɹk
ɹeɹfnoɹdsɹef	ɹeɹfnoɹtsɹef
ansnissnop	ansnissnop
uɹdgɹigpɸon	uɹtkɹɪgpfon
nɔlɢuplɹiɹl	nɔlgʊplɹɪɹl
βœɹldɹæɹfɹes	bɛɹltɹaɹfɹes
zɔsɛblɹuɹt	dɔtɛblɹʊɹt
gɹiɹnsuɹbnɹa	gɹɪɹnsuɹbnɹa
xetɢɔfpgɹɛt	ketgɔfpkɹɛd
ɹɛɹbɹuɹbnop	ɹɛɹbɹʊɹpnop
zɛtqɔɹdgɹoɹn	dɛtkɔɹdkɹoɹn
nɹɛlɣetzuɹk	nɹɛlgetduɹk
lɹiplɹoɹlfut	lɹiplɹoɹlfut
gɹuɹgɸɔɹlgɹi	kɹʊɹgpɔɹlgɹi
lɹiɹggɹæfzeɹp	lɹɪɹkkɹafdeɹp
tæɹzobfɹo	taɹdobfɹo
fɹoɹnɹoɹnlæn	fɹoɹnɹoɹnlan
pɸobfɹuɹfbɹep	pfobfɹuɹfbɹeb
ɹekdɹigsɔs	ɹekdɹɪgsɔs
ɸøfnɹiɹggɹiɹ	pefnɹɪɹggɹiɹ
ifliɹgɹæfp	ifliɹgɹafp
gɹuɹlfiɹffip	kɹuɹlfɪɹffib
fɹeddɹoɹmpɸeɹf	fɹedtɹoɹnpfeɹf
fɔbsnɛɹlzul	fɔbsnɛɹldul
ɸɶfpxinsbɹon	pafpkɪnsbɹon
tsiflɛɹbqup	tsɪflɛɹbkʊb
snustsnuɹgbɹek	snustsnuɹkpɹek
dɹælnipɸun	dɹalnipfun
tsiɹgɹɔɹsbyɹl	tsiɹgɹɔɹsbɪɹl
sinseddɹin	tɪntedtɹin
fɹɛɹgquɹbfɹeɹk	fɹɛɹgkuɹpfɹeɹg
soɹdβɔɹlsip	toɹdbɔɹlsip
snɔfpnɹigɸɔɹk	snɔfpnɹigpɔɹk
βistsiɹbdɹɔns	bisttiɹbtɹɔns
ɣilzoɹdbɹif	gɪldoɹtbɹif
sɹiɹgɹoɹnɔp	sɹiɹgɹoɹnɔb
nɹɛxeɹlsɹiɹp	nɹɛkeɹlsɹɪɹp
fifɸifɛp	fifpifɛb
ɸuxɛsfɔp	pʊkɛsfɔb
fuzɔɹlgɹɔl	fudɔɹlgɹɔl
ɸœtbɹofɹiɹt	pɛtpɹofɹɪɹt
qokbɹesɹæt	kokpɹesɹad
ɸɶnsdɹuɹgbɹeɹp	panstɹʊɹkpɹeɹp
pɸɛɹmβotdæns	pfɛɹnbotdans
gɹiɹdsɛlsnofp	gɹiɹtsɛlsnofp
bɹibnutbɹol	bɹibnʊtbɹol
ɹæggɹepɸiɹk	ɹagkɹepfɪɹk
odtsuɹgɸøɹl	odtsuɹkpeɹl
fɹifnɹuɹdseɹs	fɹɪfnɹuɹtseɹs
sɛɹbbɹægkæk	sɛɹpbɹagkak
zifpdɹefpsneɹt	difpdɹefpsneɹd
pɸæseɹnlɹiɹk	pfaseɹnlɹiɹg
niɹftsɛkdɹit	nɪɹftsɛktɹɪt
gɹeɹŋgɹeɹmpɸost	kɹeɹnkɹeɹnpfost
seɢɔnsnuɹt	tegɔnsnuɹt
ɹesxeɹŋɣik	ɹeskeɹngɪk
bɹoɹgbɹɛɹbsɹik	bɹoɹgpɹɛɹpsɹik
dɹændɹɛksɹo	tɹandɹɛksɹo
gɹɛnlufɸøfp	kɹɛnlʊfpefp
snoɹdlɹuglɹɛf	snoɹdlɹʊglɹɛf
pɸɛzɔdɣip	pfɛdɔdgɪb
lidtsɔlbɹit	lɪdtsɔlbɹɪd
snegɹɔɣit	snegɹɔgid
pɸæsgɹikɣin	pfasgɹɪkgɪn
uɹdsɹukzot	ʊɹtsɹukdot
pɸɛlfɔɹgniɹp	pfɛlfɔɹgniɹp
dɹænszefpziɹt	tɹansdefpdɪɹd
snuɹsfɹɔɹfdɹæk	snuɹsfɹɔɹfdɹag
tsoɹgtsibɸøɹl	tsoɹktsɪbpeɹl
asdɹɔɹbbɹit	astɹɔɹbpɹɪd
dɹikɢobɹuɹl	tɹikgopɹʊɹl
ɹidɸɔsfɹuɹp	ɹɪdpɔsfɹʊɹb
lɹɛfɛfnɹeɹs	lɹɛfɛfnɹeɹs
snoɹgbɹognɹon	snoɹkbɹognɹon
pɸegβusbyk	pfegbusbɪg
nɹostsɛslɹuɹp	nɹostsɛslɹʊɹb
ɸønlædfɹos	penladfɹos
snoɹgbɹæɹlβɶfp	snoɹkbɹaɹlbafp
zeksɹunneɹl	deksɹunneɹl
qudɹiɹfdɹu	kudɹiɹfdɹu
bɹoɹfβitsuɹf	bɹoɹfbitsʊɹf
sɹuɹmɸœtloɹ	sɹʊɹnpɛtloɹ
dɹuɹgnɹæɹgnins	dɹʊɹgnɹaɹgnɪns
nimɸɔɹbɸøɹl	nɪnpɔɹbpeɹl
βoɹbβonsik	boɹpbonsig
ɹuɹdsɹulɹon	ɹʊɹdsɹulɹon
sɔɹdsɹupla	sɔɹdsɹupla
pypsnɛsgɹun	pɪpsnɛsgɹʊn
ɸøɹdɣiflɹiɹt	peɹtgiflɹɪɹd
oɹssɹoksil	oɹssɹoktɪl
ɢuɹdæfpdɹɛt	gʊɹtafptɹɛt
nɹiklɹipbɹuɹk	nɹiklɹɪppɹuɹg
sɹæstdɹefpɸo	sɹasttɹefpfo
nɹɔfɛtsuk	nɹɔfɛtsug
ɹeɹgbɹitβɶɹk	ɹeɹkbɹɪtbaɹk
bɹiɹlgɹuɹbbɹuɹk	pɹɪɹlgɹuɹbbɹuɹk
altsæknu	altsaknu
gɹɔsnɹotnet	gɹɔsnɹotnet
feɹgnɛɹfβɶf	feɹgnɛɹfbaf
aɹdfɹiɹglæɹn	aɹtfɹɪɹglaɹn
gɹelpɸæɹgbɹup	gɹelpfaɹkbɹup
tsiɹbɸiɹnsnup	tsiɹppiɹnsnʊp
bɹɛgfoɹdsɔ	bɹɛgfoɹtsɔ
lunszifɢɔk	lʊnsdifgɔk
ɸɔglɹusdɹut	pɔglɹusdɹud
gɹosɛŋɣit	gɹosɛngɪd
ɸœɹbsiɹmβot	pɛɹptɪɹnbod
ɹeɹdsnɔfpɸæst	ɹeɹdsnɔfpfast
sɹoɹzɛstbɹut	sɹoɹtɛstpɹut
ɣiɹgtsɔnslɹiɹk	giɹgtsɔnslɹɪɹg
sɹiɹsunsɹɔɹt	sɹɪɹsunsɹɔɹd
gɹæfpdɹupdɹɔɹl	kɹafpdɹuptɹɔɹl
nɹifplɹæksɹeɹn	nɹɪfplɹaksɹeɹn
tsenspyɹlsiɹf	tsenspɪɹlsɪɹf
fɹæzɛɹddɹɔn	fɹadɛɹtdɹɔn
lɹægdɹesɔfp	lɹagdɹesɔfp
gɹuɹlbɹolxest	kɹuɹlpɹolkest
ɔnssnuɹdbyns	ɔnssnuɹdbɪns
nɹuɹbpɸidsnep	nɹuɹbpfɪdsnep
snigβuɹlpɸæt	snigbʊɹlpfad
soɹlɹostsɛk	toɹlɹosttɛk
dɹensbɹɔɹssɔɹk	dɹensbɹɔɹstɔɹg
bɹuɹfnɹæfpgɹuɹl	bɹuɹfnɹafpkɹuɹl
tsɔblɹiɹgbɹil	tsɔblɹiɹkbɹɪl
gɹiɹgdɹiɹgɣis	gɹiɹkdɹɪɹggis
soglɔpys	soglɔpɪs
negɹedgɹep	nekɹedkɹep
bɹobβøɹgbyɹp	pɹobbeɹkbɪɹb
nɹæɹbɹiɹbtsiɹk	nɹaɹbɹɪɹptsiɹg
tsæɹɣifpbɹɔɹf	tsaɹgɪfppɹɔɹf
xinæɹmɸɶs	kɪnaɹnpas
dɹopɸuɹbgɹɔp	tɹopfʊɹpkɹɔb
soɹnnɛbluns	toɹnnɛblʊns
ikxibtsɔɹt	ikkɪbtsɔɹt
βuɹdseɹdnɹen	buɹtseɹdnɹen
fɛdtsɔdsɹon	fɛdtsɔdsɹon
læbtsifpɸɹiɹt	labtsifpfɹiɹt
ɢɔgfɹɔgdɹit	gɔgfɹɔgdɹid
leɹdɹettsɔp	leɹtɹettsɔp
bɹefptsiknɹæs	pɹefptsiknɹas
fɹægdɹɛkbɹiɹk	fɹagdɹɛkpɹɪɹg
nodtsopnɛɹk	nodtsopnɛɹg
pɸekxedquɹk	pfekkedkʊɹk
susbɹugbɹeɹ	suspɹugbɹeɹ
zuɹfɢunsɸœfp	dʊɹfgʊnspɛfp
dɹæksɹiɹgziɹk	dɹaksɹɪɹgdiɹk
pɸugɹeɹgzust	pfugɹeɹkdust
sɹæɹssɛβit	sɹaɹstɛbid
gɹugsnoɹgbɹæk	gɹugsnoɹkpɹak
ɸufsnoɹmbɹust	pufsnoɹnbɹust
sænsneɹɣep	sansneɹkeb
lɹostpɸɛnsgɹut	lɹostpfɛnskɹʊd
seɹgpɸuknɛɹs	teɹkpfʊknɛɹs
ɸupsɹifpβuɹn	pʊpsɹifpbuɹn
olnɹipnɛɹp	olnɹipnɛɹb
tsɔttætæɹk	tsɔttataɹg
suɹdlɹɛbgɹuk	suɹtlɹɛbkɹʊk
fefptsimpɸen	fefptsinpfen
sifgɹefpxet	tɪfgɹefpket
βuɹfquɹndɹuɹs	buɹfkʊɹndɹuɹs
bɹɛnussit	bɹɛnussɪt
nestqusβɔɹf	nestkʊsbɔɹf
seɹftsuɹnsɹo	seɹftsuɹnsɹo
folbɹuɹbyɹl	folbɹʊɹpɪɹl
snotbɹuɹbqul	snotbɹuɹpkul
βopluɹlɹæn	bopluɹlɹan
pɸuɹgɹæɹbzeɹl	pfuɹgɹaɹbdeɹl
bɹiɹlpɸibɹæt	pɹiɹlpfibɹat
ɔgɹɔbgɹæɹs	ɔgɹɔbgɹaɹs
xifdɹustɸoɹt	kiftɹustpoɹt
uɹgfɹuɹsfe	ʊɹgfɹʊɹsfe
bɹɔnsbɹuŋqus	bɹɔnspɹunkus
sniɹbβuɹgbɹiɹt	sniɹpbʊɹkbɹɪɹd
sɹulqufbɹuɹk	sɹʊlkufpɹʊɹk
zibɹuffɹul	dɪbɹuffɹul
lotsupɸɛk	lotsupfɛg
ɣɛtzogβɔɹk	gɛtdogbɔɹg
sistbɹɛɹsqost	sistbɹɛɹskost
bɹedɹɛdsip	bɹedɹɛdsɪb
βøɹgpɸɔɹflɛp	beɹkpfɔɹflɛp
gɹuɹbɹæfbɹins	kɹʊɹbɹafbɹins
dɹiɹfsɹunslɛɹ	tɹiɹfsɹunslɛɹ
bysdɹɛɹbtsæt	bɪstɹɛɹptsat
foɹdtsinsnuk	foɹttsɪnsnuk
gɹoɹbfɹuɹfsɛɹt	kɹoɹpfɹuɹftɛɹt
sinɹesɹɛɹp	sinɹesɹɛɹp
tsɛdlɹuɹgɸœp	tsɛdlɹuɹkpɛb
tsipɣɛgɣiɹs	tsɪpgɛggiɹs
ɹæsfɹikfeɹ	ɹasfɹɪkfeɹ
ɔfugtsɔk	ɔfugtsɔk
pɸensnɹæɹlnɹefp	pfensnɹaɹlnɹefp
nɹæstdɹimbɹel	nɹasttɹɪnpɹel
sulβinlɹuɹt	sʊlbinlɹʊɹt
fiɹsfonsβœɹt	fiɹsfonsbɛɹd
pyggɹoŋxeɹl	pɪgkɹonkeɹl
dɹæɹdɹoɹskæɹs	tɹaɹdɹoɹskaɹs
ɣidɹɛɹfgɹæɹp	gidɹɛɹfkɹaɹb
gɹiɹŋgɹuɸok	kɹɪɹnkɹʊpog
ɢossiblɛk	gostiblɛg
dɹofpɸødlɛp	tɹofppedlɛp
seɹbgɹuɹbsnɔɹk	seɹpgɹuɹpsnɔɹk
feɹgzuɹŋgɹist	feɹkdʊɹnkɹɪst
sifɸɶɹdsɛfp	sifpaɹtsɛfp
snuɹblubgɹek	snʊɹplʊbkɹeg
siɹdtsibpɸo	sɪɹdtsibpfo
suɹβɔɹbbɹɛt	suɹbɔɹpbɹɛt
fɛfpsosxis	fɛfpsoskɪs
suɹsɹæfplu	tuɹsɹafplu
bɹuɹdɹiɹsɹɔs	bɹʊɹtɹɪɹsɹɔs
fefsudβuɹs	feftudbuɹs
dɹɔdbɹæɹsnɛn	tɹɔdpɹaɹsnɛn
pɸoɹfnɹɔɹdqoɹl	pfoɹfnɹɔɹdkoɹl
feɹbɸɔgbɹofp	feɹppɔgpɹofp
gɹiɹbdɹitnɹɔp	kɹɪɹpdɹɪtnɹɔp
tsuksnibgɹɔɹk	tsʊksnɪbkɹɔɹg
fɹufɹisβɶf	fɹufɹisbaf
nɹænsɹimbyɹt	nɹansɹinbɪɹt
ziɹmbɹitsnɔp	diɹnbɹɪtsnɔp
βɶɹglɹistgɹɛt	baɹglɹɪstgɹɛt
qunsudlut	kunsudlud
pɸæstzukniɹf	pfastdʊkniɹf
fɹiɹgβɶdtsik	fɹɪɹgbadtsɪk
gɹistfosɛɹl	kɹistfosɛɹl
gɹæfpɢɔɹŋgɹɛ	kɹafpgɔɹnkɹɛ
gɹæɹllɔɹdqun	kɹaɹllɔɹdkʊn
gɹæfpnɹussɔɹs	kɹafpnɹustɔɹs
βubpɸelsɹek	bubpfelsɹeg
gɹæɹlɹuɹbzut	kɹaɹlɹʊɹpdut
bɹɛpdɹugɹoɹt	bɹɛptɹʊkɹoɹt
ɸɶtfɹuɹbxip	patfɹʊɹpkɪb
nɔfpɸɔɹdgɹoɹn	nɔfpfɔɹdgɹoɹn
fiɹgsnusnɹit	fɪɹksnusnɹɪt
seɹzobsɹiɹf	seɹtobsɹiɹf
lætluɹgfɹif	latlʊɹkfɹif
fɹostpɸugsɛfp	fɹostpfugsɛfp
fipsnɔɹltsen	fɪpsnɔɹltsen
fupdɹuɹgloɹn	fuptɹuɹkloɹn
ɹiɹdbɹuɹsbɹit	ɹɪɹdbɹʊɹspɹit
lɹænsxensɔt	lɹanskentɔt
gɹɛstdæɣiɹ	kɹɛstdagiɹ
bɹeɹsnenssɛɹk	bɹeɹsnenssɛɹk
pɸeɹbdɹefdæp	pfeɹptɹefdap
suɹgfɹinsdɹil	suɹgfɹinstɹil
pɸiɹsqoɹlɸøɹt	pfɪɹskoɹlpeɹd
sɹoknokbɹut	sɹoknokpɹʊd
bɹebdɹɛɹgdɹɛt	pɹebdɹɛɹgtɹɛd
asɔsɣɛɹp	asɔsgɛɹp
lɔɹgɹæpdɹɔɹn	lɔɹgɹapdɹɔɹn
nɹeɢutnɹip	nɹegutnɹib
zufbɹuɹdqoɹs	dʊfbɹʊɹdkoɹs
bɹuɹdpɸuɹftsæɹp	pɹuɹtpfʊɹftsaɹb
bɹesɹintsos	pɹesɹintsos
fiɹdbɹuɹfβoɹl	fiɹtbɹʊɹfboɹl
dɹætsnæɹsdæl	tɹatsnaɹsdal
sɔpsɹuɹlsɹæk	tɔpsɹʊɹlsɹag
suɹnnɹoɹdsɛɹn	tuɹnnɹoɹdsɛɹn
dɹikninnɹæk	dɹɪkninnɹag
zɔɹbfælnɹos	dɔɹpfalnɹos
qutsuɹssup	kʊtsuɹstʊp
fɹuɹdbɹikgɹuɹs	fɹʊɹtbɹɪkgɹʊɹs
nɛɹlɹeɹdgɹɔɹl	nɛɹlɹeɹtkɹɔɹl
bɹæggɹæmβiɹt	bɹagkɹanbiɹd
bɹudlepsnoɹk	pɹʊdlepsnoɹg
bɹolsnuɹgniɹt	bɹolsnʊɹkniɹd
ɢunssiɹggɹɛɹt	gunstiɹgkɹɛɹt
uɹdfɹɛtgɹeɹp	uɹdfɹɛtkɹeɹp
gɹigbɹigxis	gɹigpɹɪgkis
neɹsgɹuɹβɔɹk	neɹsgɹʊɹbɔɹk
pɸunszuɹbβufp	pfunsdʊɹbbʊfp
suɹlɹɛfpzuɹf	tuɹlɹɛfpduɹf
snebbɹoɹgxɛp	snebpɹoɹgkɛp
dɹisnɹeɹgxi	dɹisnɹeɹgki
gɹɔɹlsoɹnoɹt	kɹɔɹlsoɹnoɹd
lɹiɹdbɹiɹggɹɔl	lɹɪɹtpɹiɹkgɹɔl
βɔɹdsɹukpɸiɹk	bɔɹtsɹukpfiɹk
undɹɛmpɸist	ʊntɹɛnpfɪst
sɛlbɹækbɹuɹp	tɛlbɹakbɹʊɹp
ziɹgpɸæɹlnɹɔɹ	diɹgpfaɹlnɹɔɹ
tsɛɹfβøsttsil	tsɛɹfbesttsɪl
tsustlɹɛɹsɣif	tsustlɹɛɹsgɪf
ɢɔlɣɛɹɢut	gɔlgɛɹgʊt
snustɸifpnɹin	snustpifpnɹin
ɢɔdfɔɹzuɹt	gɔdfɔɹtuɹd
bɹuntseɹgsɹɔl	bɹuntseɹksɹɔl
sɔɹgsɔɹgzit	tɔɹgsɔɹkdit
qobɣigɹɔɹf	kobgikɹɔɹf
fæɹszɛɹfɛ	faɹsdɛɹfɛ
tsɔɹsxiɹlgɹɔɹ	tsɔɹskɪɹlkɹɔɹ
dɹoɹdzoɹgxet	dɹoɹtdoɹgked
sɛksɔfpsoɹf	tɛktɔfptoɹf
bɹɔɹdfɹeɹɣip	bɹɔɹtfɹeɹkib
lɹiɹltsuɹbxɛt	lɹiɹltsʊɹbkɛt
bɹoɹnnɹɛɹɱfeɹp	bɹoɹnnɹɛɹnfeɹb
ɹiɹbsɹoɹffɹɛns	ɹɪɹbsɹoɹffɹɛns
dɹiŋgɹeldɹup	dɹinkɹeldɹub
dɹɔɹssɹuɹlzoɹf	dɹɔɹssɹuɹldoɹf
zostxilgɹok	dostkilkɹog
sɹæɹbgɹuɹzi	sɹaɹbkɹʊɹdi
gɹosnɹuɹnnɹæɹp	gɹosnɹʊɹnnɹaɹp
sizosluɹk	tidoslʊɹg
βuɹgbɹekgɹɔɹl	bʊɹkpɹekgɹɔɹl
snuɹbsɹiɹblɹæn	snuɹpsɹɪɹblɹan
lɹæfpqoɹggɹeɹs	lɹafpkoɹgkɹeɹs
sɹɔtsolqoɹl	sɹɔttolkoɹl
ɸœɹbgɹiɹgtsæɹp	pɛɹpgɹiɹktsaɹp
dɹikzɔfɣiɹn	dɹɪkdɔfgɪɹn
ɣiɹɣelbɹul	gɪɹkelbɹul
lɹædgɹæslɹop	lɹadkɹaslɹob
gɹossuɹfnɹek	kɹostʊɹfnɹek
zogɸɔɹgfɹuɹl	dogpɔɹgfɹʊɹl
dɹuɹfɹolɔt	tɹuɹfɹolɔt
nɹestfɔstpɸiɹn	nɹestfɔstpfiɹn
zeɹfɣibɹins	deɹfgɪpɹins
pɸubzuɹfɸons	pfubduɹfpons
βiɹdsninsgɹek	biɹtsnɪnsgɹek
gɹɔpβusβu	kɹɔpbʊsbʊ
fufdɹolβup	fʊftɹolbub
sælsɹɛɹdnɹeɹk	salsɹɛɹdnɹeɹg
sɔtnɔɹgæɹt	sɔtnɔɹkaɹt
βuɹlbɹupɸet	buɹlbɹʊpfed
ɣɛɹzusgɹæs	gɛɹtʊsgɹas
sɹɛbɹuɹfsɹi	sɹɛbɹuɹfsɹɪ
lɛpɢojɹp	lɛpgoiɹp
ɸɶdsɹuɹglɹifp	padsɹʊɹklɹifp
bɹuɹzoɹgpɸɛɹp	bɹuɹdoɹgpfɛɹp
sɔɹgquɹmɸøt	tɔɹkkʊɹnpet
bɹuɹllɛflɹoɹt	bɹuɹllɛflɹoɹt
ɸɔɹlæffɹiɹt	pɔɹlaffɹiɹt
fɹɛfpɸuɹbβɔɹl	fɹɛfppʊɹbbɔɹl
pɸiɹdbɹetɢust	pfiɹdpɹetgʊst
ɣistgɹɛsɹest	gistgɹɛsɹest
sɹedtseɹdbɹæɹf	sɹedtseɹtbɹaɹf
tsudæsttset	tsʊdasttset
gɹuɹlgɹiɹzik	kɹʊɹlkɹɪɹtɪg
gæfppɸɔɹgbɹuɹn	gafppfɔɹgbɹʊɹn
ɹixeɹddɹuns	ɹikeɹddɹuns
zisbɹupɸæɹt	dispɹupfaɹt
bɹuɹgɸɔɹsβip	bɹʊɹkpɔɹsbip
fɹistfɛflifp	fɹɪstfɛflɪfp
bɹifnæɹgbɹæns	bɹifnaɹgpɹans
gɹɔŋgɹænsdɹup	kɹɔngɹansdɹub
dɹiɹdfɹestpɸiɹs	tɹiɹdfɹestpfiɹs
tsoktsæɹdɣifp	tsoktsaɹtgɪfp
feggɹɔgnæl	feggɹɔgnal
sɹɛɹlloɹdsnist	sɹɛɹlloɹtsnist
dɹɛɹgfɹɛɹgdɹɔɹs	tɹɛɹgfɹɛɹgtɹɔɹs
gɹæɹbsidsnit	kɹaɹpsɪdsnid
βugtsupyn	bʊgtsupɪn
tsɛssinsdɹek	tsɛstinstɹek
nistlɹeɹɢun	nistlɹeɹgʊn
snoklɹoɹfzoɹp	snoklɹoɹfdoɹp
siɹsnɹiɹɣil	tɪɹsnɹɪɹgɪl
bɹeɹbgɹjɛs	bɹeɹpgɹiɛs
dæɹdfɹosbɹuns	daɹdfɹospɹuns
siɹmbɹokpɸop	tɪɹnpɹokpfob
fɹoɹgdɹugsɔs	fɹoɹkdɹugsɔs
ɣenstsæmβɶp	genstsanbap
ziɹslɹustsuɹt	dɪɹslɹʊstsuɹt
gɹuɹgbyɹgfit	kɹuɹgbɪɹkfɪt
zɔklɹesnun	dɔklɹesnʊn
xisotgɹuɹ	kitotgɹuɹ
sɔɹɱfɹosdɹæɹl	sɔɹnfɹostɹaɹl
ɸœplɹoglɹop	pɛplɹoglɹop
snelsɔnsluf	snelsɔnsluf
gɹæstzɔɹbbɹi	gɹastdɔɹpbɹɪ
ɣipdɹɛɹgsip	giptɹɛɹgtɪb
βibzuɹdɹut	bibdʊɹdɹut
gɹustsɛtbɹus	kɹustsɛtpɹʊs
gɹedsɹɛɹdnip	kɹedsɹɛɹdnɪp
dɹefpliɹsɣeɹf	tɹefpliɹsgeɹf
nɹefpsnɔɹflɹek	nɹefpsnɔɹflɹeg
ɹɔɹbgɹiɹdɹok	ɹɔɹbkɹɪɹtɹog
fɹæɹdzunsnɹi	fɹaɹddunsnɹɪ
ɢuspɸuɹdzɔɹp	guspfuɹtdɔɹp
sɹælbɹolfɹuk	sɹalbɹolfɹug
dɹiɹbxepdɹuf	tɹɪɹbkepdɹuf
tsɔɹɱfɹɔɹgsot	tsɔɹnfɹɔɹgsod
gɹidɹetdɹiɹl	kɹɪdɹettɹɪɹl
snæɹgtsɛɹdsɹɛɹ	snaɹktsɛɹdsɹɛɹ
sæɹfβœlfɹɔt	saɹfbɛlfɹɔt
gɹiɹslɹɔɹsfɹen	gɹɪɹslɹɔɹsfɹen
pɸutdɹinssnuɹp	pfutdɹinssnuɹp
bɹɛtgɹepse	bɹɛtgɹepte
bɹuɹdbɹutbɹut	pɹuɹtbɹʊtpɹʊd
fɹeɹgfɹɔluɹp	fɹeɹkfɹɔlʊɹp
nistfɔɹfqɔɹn	nɪstfɔɹfkɔɹn
pɸæfɣensɹun	pfafgensɹun
fensleɹfbɹist	fensleɹfbɹist
gɹɛtlɹɛksɹeɹl	gɹɛtlɹɛksɹeɹl
ubdɹugɹɛɹk	ubdɹugɹɛɹg
ɹɔlsugsnut	ɹɔlsʊgsnʊt
fɹɔɹgɢɔfop	fɹɔɹkgɔfop
bɹelxekdɹoɹp	pɹelkekdɹoɹp
fæɹbgæɹldɹuɹl	faɹbgaɹltɹʊɹl
ɹuɹftsiɹfnit	ɹʊɹftsiɹfnid
bɹinsfɹɛdsæɹp	bɹinsfɹɛdsaɹp
ɸœpβøɹdbɹɔɹf	pɛpbeɹdpɹɔɹf
aβɔdxet	abɔdket
suɹdsiɹfβit	sʊɹdtiɹfbid
loɹbdɹopneɹ	loɹptɹopneɹ
ɸustnɹæfsnit	pustnɹafsnit
sɹikpɸiklɹik	sɹɪkpfiklɹɪk
dɹiɹbpɸuɹɢuk	dɹɪɹbpfʊɹgʊg
fɹiɹsiɹlfɹæɹp	fɹiɹsɪɹlfɹaɹb
ɣiɹsgɹuɹdlɔɹ	gɪɹsgɹuɹdlɔɹ
suɹdsentsoɹl	sʊɹtsentsoɹl
lonsdɹiɹdliɹk	lonsdɹɪɹdlɪɹk
zustgɹigɢuɹp	dʊstkɹɪgguɹp
dɹɛnssɹoɹfɹɔst	tɹɛnssɹoɹfɹɔst
pɸebɹiɹndɹæt	pfebɹɪɹntɹad
fɹuɹbsiɹbɹɔns	fɹuɹpsɪɹpɹɔns
sɹistdɹuɹltsun	sɹɪsttɹʊɹltsun
bɹuspɸæɹdbɹeɹ	pɹuspfaɹtbɹeɹ
sɹelnɔɹsnef	sɹelnɔɹsnef
tsiɹbsægsefp	tsiɹbsagsefp
nɹɔfɹɛbfoɹs	nɹɔfɹɛbfoɹs
pɸiɹgsonsik	pfiɹgtonsɪk
ɸɶtnɹɔfɸɶn	patnɹɔfpan
leɹstsiɹblɹæn	leɹstsɪɹblɹan
βøɹseɹlbɹeɹp	beɹseɹlbɹeɹp
snuffælgɹɔt	snuffalgɹɔt
pɸepnɹiɹlnæfp	pfepnɹiɹlnafp
tsɛfsnoplæfp	tsɛfsnoplafp
ɸœnsgɹɔnnoɹt	pɛnsgɹɔnnoɹd
bɹunoɹbfɹist	bɹunoɹpfɹist
pɸuɹbɸɔklɹeɹl	pfuɹppɔklɹeɹl
bɹugɸupbɹofp	pɹʊgpuppɹofp
snɛɹdɹoɹnlɹofp	snɛɹdɹoɹnlɹofp
bɹuɹglodβoɹf	bɹʊɹklodboɹf
nɹedsɔnsɸɔp	nɹedsɔnspɔb
zifpsnolfɛɹn	dɪfpsnolfɛɹn
zustsɔɹgbɹuns	dʊsttɔɹkbɹʊns
qoɹfigbɹɛɹt	koɹfɪgpɹɛɹt
nɛstlɹæɹdfɹeɹf	nɛstlɹaɹtfɹeɹf
lɹittsoɹdliɹt	lɹɪttsoɹtlɪɹt
sninsgɹuktsik	sninsgɹʊktsɪk
nɛɹbziɹdbɹof	nɛɹbdiɹtpɹof
βuɹgfɹidfɹæp	bʊɹkfɹidfɹab
lɹɛdgɹeslun	lɹɛdgɹeslun
bɹɔfpsnæɹlgɹæp	pɹɔfpsnaɹlgɹab
nɹænsfɛɹgni	nɹansfɛɹkni
tsɛɹdsædɹuɹf	tsɛɹtsatɹuɹf
agɹɔpβɔɹt	agɹɔpbɔɹt
βuɹssotdɹup	bʊɹssotdɹub
nɹistsæspɸi	nɹɪstsaspfi
qoddɹefpnuɹt	kodtɹefpnuɹt
gɹæɹsɔɹflɔ	kɹaɹsɔɹflɔ
nɹonsɹosiɹk	nɹonsɹosiɹg
nuɹbpɸostgɹul	nuɹbpfostkɹʊl
dɹuknɹɔbgɹoɹk	tɹuknɹɔbkɹoɹk
gɹibɹustnɹist	kɹɪbɹustnɹɪst
dɹuffɹuɹfpɸuɹt	tɹʊffɹʊɹfpfʊɹd
nɹɛɹlzutsɔɹk	nɹɛɹlduttɔɹk
niɹldɹɔfsɹe	nɪɹltɹɔfsɹe
lɹutsɔɹszup	lɹutsɔɹsdub
nɔstsɹusdɹɔɹt	nɔstsɹʊstɹɔɹd
sɹuɹsɹɛgzok	sɹuɹsɹɛgdok
lɹɔfpɸɔstfɹoɹp	lɹɔfpfɔstfɹoɹp
ɢosnæɹbpɸæt	gosnaɹppfat
lɔfdɹuɹgβɔn	lɔfdɹuɹkbɔn
xɛɹdxesfuɹp	kɛɹdkesfuɹb
fɛɹglɹublip	fɛɹglɹublɪb
ɸuɹlnɹɛɹssɹoɹl	puɹlnɹɛɹssɹoɹl
ɸifɹiɹsseɹk	pifɹɪɹsteɹg
feɹdɣeɹstsup	feɹtgeɹstsʊp
tsɔbɹuɹbtsɛɹk	tsɔbɹʊɹbtsɛɹg
βɶnszɔɹfnɹik	bansdɔɹfnɹɪg
lɹɛbtsɛgɹuɹs	lɹɛbtsɛkɹuɹs
dɹobtseɹliɹl	tɹobtseɹlɪɹl
ɹɔbɹæfsuɹp	ɹɔbɹafsʊɹp
gɹostsensɹiɹp	gɹostsensɹiɹp
lefptsegpɸæst	lefptsegpfast
snuɹdɢuldɹɛn	snʊɹtguldɹɛn
qɔɹdɢuɹzuf	kɔɹdgʊɹdʊf
gɹuɹbbɹægɹuk	kɹʊɹpbɹakɹʊg
lɹuppɸofplɹons	lɹuppfofplɹons
ɹilɹistzoɹs	ɹilɹɪstdoɹs
feɹbxɛɹspɸæst	feɹpkɛɹspfast
bɹoɹnnɛpset	bɹoɹnnɛpsed
ɹisfibsæt	ɹɪsfibsat
dɹubɹesnɛn	tɹʊbɹesnɛn
gɹuɹsɣɛbsɹis	kɹʊɹsgɛbsɹis
tsiɹdsɹuɹbsiɹf	tsɪɹtsɹʊɹbtɪɹf
fɔdpɸuttsɛɹt	fɔdpfuttsɛɹt
gɹiɹgɢofbɹifp	gɹiɹggofpɹɪfp
dɹɛgbɹulpɸif	tɹɛgbɹʊlpfif
gɹækfusoɹ	gɹakfʊtoɹ
ɣinsdɹupɸuɹp	ginstɹupfʊɹp
gɹidpɸæɹbnɹiɹl	gɹɪdpfaɹpnɹiɹl
bɹufpdɹibsnæfp	pɹʊfpdɹɪbsnafp
lɹilβistbɹuf	lɹilbistbɹʊf
dɹiɹlgɹuɹddɹifp	tɹɪɹlkɹuɹddɹɪfp
fekgɹiɹblut	fekkɹɪɹplʊd
sniɹbfufpseɹl	snɪɹpfufpseɹl
tæfgɹeɹglɹiɹk	tafgɹeɹglɹɪɹk
βɶɹgsnuɹgfɹɛfp	baɹksnʊɹgfɹɛfp
ifpbɹistæt	ɪfppɹistat
gɹɔɹdfɹindɹæst	gɹɔɹdfɹintɹast
ɢolnɛfpzol	golnɛfpdol
ɹinsdɹestbɹɔɹf	ɹinsdɹestpɹɔɹf
tsiɹbβøɹssɹæɹk	tsiɹpbeɹssɹaɹk
fusfɹifppɸæɹn	fusfɹɪfppfaɹn
pɸæfpbɹelqɔfp	pfafppɹelkɔfp
bɹoɹdβɶkbɹæk	pɹoɹdbakbɹak
sɹætgɹosɣist	sɹatgɹosgist
fɹædgɹoɹbɹuɹf	fɹadgɹoɹbɹʊɹf
pɸuɹɱfɹɔpniɹl	pfuɹnfɹɔpniɹl
nɹogɹɔɹbbɹɛɹs	nɹokɹɔɹpbɹɛɹs
ɸokgɹibdɹiɹt	pokkɹibdɹiɹd
gɹoɹgsɹotfɹoɹ	kɹoɹksɹotfɹoɹ
fɹuɹdsisu	fɹʊɹttɪtʊ
suftsæɹgɹoɹ	tʊftsaɹgɹoɹ
sæɹgzetfɹiɹp	saɹgdetfɹiɹp
tsoɹbɹoɹlbɹeɹt	tsoɹbɹoɹlbɹeɹd
xesɹæɹsoɹt	kesɹaɹsoɹd
gɹefppɸuɹgβøɹp	kɹefppfuɹgbeɹb
dɹiɹgsubtsut	dɹɪɹktubtsut
dɹæsuleɹs	dɹatuleɹs
lɹinsgɹiɹlbɹiɹ	lɹinskɹiɹlpɹɪɹ
nɹugdɹegzɛf	nɹʊgdɹegdɛf
ɸuɹlbɹomβœɹp	puɹlpɹonbɛɹp
lɹætsɔɹblɹuɹs	lɹattɔɹplɹuɹs
gɹæβonssnel	kɹabonssnel
suɹgɹoɹggɹɛp	sʊɹgɹoɹggɹɛb
pɸuɹndɹunzo	pfʊɹndɹundo
læfnæɹgliɹp	lafnaɹgliɹb
sɔppɸupdæf	tɔppfʊpdaf
soɹsbɹɔdfiɹk	soɹsbɹɔdfɪɹg
sɹuknɹestsik	sɹʊknɹestsɪg
sɹekbɹætnɹɔp	sɹekbɹatnɹɔp
nɹistfæpnɹiɹp	nɹɪstfapnɹɪɹb
tsuŋgɹebɹuɹp	tsʊngɹebɹuɹp
otlikfɹuɹt	otlikfɹuɹt
tsæɹbβifppɸuɹt	tsaɹpbifppfuɹd
gɹɔlnɹefpbɹuns	kɹɔlnɹefppɹuns
fuɹbxiɹdgɹeɹp	fʊɹbkɪɹtkɹeɹp
gɹɛɹbfostnɹeɹk	kɹɛɹpfostnɹeɹg
lɹuɹgnɹoɹbnɹæfp	lɹuɹgnɹoɹbnɹafp
lɹembɹɔfpsoɹ	lɹenpɹɔfpsoɹ
bɹɛɹsbɹiɹdqun	bɹɛɹsbɹɪɹdkʊn
dɹɔɹfɹospɸɔɹp	tɹɔɹfɹospfɔɹb
lɹiɹbɹoɹldɹɔfp	lɹiɹpɹoɹltɹɔfp
bɹoɹgsɹɛssuk	pɹoɹksɹɛssʊg
feɹzeɹbdɹe	feɹteɹbdɹe
bɹeɹdɹistgɹɛst	bɹeɹtɹistgɹɛst
snilfɛɹllun	snɪlfɛɹllun
noɹdsnɔŋqul	noɹdsnɔnkʊl
lɹesensla	lɹesensla
fɹæpɸuɹbsuɹt	fɹapfʊɹptʊɹt
zɛgæbgɹæɹs	dɛgabkɹaɹs
siŋɣigæt	sɪngɪgat
nɹɔɹsɔɹgtsuɹn	nɹɔɹsɔɹgtsʊɹn
soɹmbɹoɹsgɹɛst	soɹnbɹoɹsgɹɛst
ɸokxɛntsuk	pokkɛntsʊk
fæglɛdlɹɔn	faglɛdlɹɔn
gɹistnɹunlɹost	kɹistnɹʊnlɹost
bɹibɸɶɱfɹup	bɹibpanfɹub
niɹnlɹæsfut	niɹnlɹasfud
qunsgɹæglɹeɹk	kunskɹaglɹeɹg
nesttæɹbsɔt	nesttaɹptɔt
quɹbnɹigæn	kuɹpnɹɪgan
pɸosttsɔstpɸæk	pfosttsɔstpfak
fidpɸifbɹɛɹt	fidpfɪfpɹɛɹt
snegzuɹlsos	snegduɹltos
ɸœfpɸublɹæp	pɛfpfublɹap
bɹogluɹmbɹoɹt	bɹogluɹnbɹoɹd
lɹukgɹuɹssust	lɹukkɹʊɹstust
filfulβofp	fɪlfulbofp
fɹæɹfɸœtdɹa	fɹaɹfpɛtdɹa
ɢuɹgtsæɹɣiɹl	guɹgtsaɹgɪɹl
zoɹlsɹæɹfsel	doɹlsɹaɹftel
fɹiɹgliɹdfik	fɹiɹklɪɹtfɪk
fɹæɹlɹudβɶɹk	fɹaɹlɹudbaɹg
nɛɹdgɹubɹiɹk	nɛɹtkɹubɹɪɹk
snɛɹbgɹækliɹp	snɛɹbgɹakliɹb
dɹiɹgnɹoltæk	dɹɪɹknɹoltag
gɹuβølnɹiɹf	gɹubelnɹiɹf
nɹoɹlbɹiɹllɹɔɹt	nɹoɹlbɹɪɹllɹɔɹt
dɹegbɹæɹdgɹuɹk	dɹegbɹaɹdkɹʊɹg
gɹæɹnofpzuɹn	kɹaɹnofpdʊɹn
zubsunslɹiɹs	dʊbsunslɹiɹs
snoɹgægsip	snoɹkagsɪp
nɹuksɹɛɹzɔn	nɹʊksɹɛɹdɔn
gɹuɹgnutgɹiɹ	gɹuɹgnʊtkɹiɹ
snolgɹelqon	snolkɹelkon
nɔgsɹensgɹuɹk	nɔgsɹensgɹuɹk
nɹeɹfɹoɹbpɸil	nɹeɹfɹoɹppfil
nɹifɹufel	nɹɪfɹufel
nuɹbsiɹlzuɹp	nʊɹptɪɹldʊɹp
iɹlgɹeɹglɹɛfp	iɹlkɹeɹglɹɛfp
lɹodfɹɔɹsnut	lɹodfɹɔɹsnut
fɔfpsɛɹgpɸiɹt	fɔfpsɛɹgpfɪɹt
fɹekfɛɹdlɹif	fɹekfɛɹdlɹɪf
bɹɔtfæɹβœɹp	bɹɔtfaɹbɛɹb
nuɹlpɸiɹbgɹɛɹk	nuɹlpfiɹpgɹɛɹg
fɹonsfɹæsnæns	fɹonsfɹasnans
bɹefziɹdpyst	pɹefdɪɹtpɪst
lɹiddɹibpɸeɹl	lɹɪdtɹibpfeɹl
snɛɹzuɹŋgɹufp	snɛɹtuɹngɹʊfp
dɹɛɹdtsiɹgdɹæst	tɹɛɹttsiɹktɹast
gɹæɹdpɸupzɔɹ	gɹaɹdpfupdɔɹ
bɹiɹbzuɹbzut	pɹɪɹbduɹpdut
niɹsɛɹgfɔk	nɪɹsɛɹgfɔk
suɹbnɹisæst	sʊɹbnɹisast
ɹosɢukɢɔk	ɹosgʊkgɔk
xɛsbɹestdɹok	kɛspɹesttɹog
ɛfbɹɔstnek	ɛfbɹɔstneg
fɹepsugqu	fɹepsʊgku
pɸuɹŋgɹibsɹiɹl	pfʊɹngɹɪbsɹɪɹl
sɹuɹffɹɔbɢɔf	sɹuɹffɹɔbgɔf
bɹipdɹeɹdɹɔp	pɹɪptɹeɹdɹɔb
ɹipgɹoɹldæɹn	ɹipkɹoɹldaɹn
gɹæfgɹjep	gɹafkɹɪeb
uɹzibɹefp	uɹtɪpɹefp
qukgɹusnoɹ	kʊkkɹusnoɹ
fɹiɹbβɔɹnsæns	fɹɪɹpbɔɹnsans
neɹsgɹifsnæɹ	neɹsgɹifsnaɹ
ɹiggɹodβøɹn	ɹɪggɹodbeɹn
βoɹdsitzɛf	boɹtsitdɛf
dɹintsɛɹlpɸek	tɹintsɛɹlpfeg
βiɹgsɹɔɹllɛɹ	biɹksɹɔɹllɛɹ
gɹosbɹɔɹlnɛt	gɹosbɹɔɹlnɛd
ɢudɸuɹbɣins	gudpʊɹpgins
gɹeɹbɸɔɹŋxiɹs	gɹeɹbpɔɹnkɪɹs
dɹoɹgɹiluɹs	dɹoɹgɹilʊɹs
ɔɹsbɹɛɹnlep	ɔɹspɹɛɹnlep
sisniɹfɹɛɹf	tɪsnɪɹfɹɛɹf
fɹuɹgluddɹɔɹn	fɹuɹgluddɹɔɹn
ensɹustlɹip	ensɹʊstlɹip
pɸekbɹænsdɹist	pfekpɹansdɹɪst
lɹeɹdbɹiɹbyɹt	lɹeɹdbɹiɹpɪɹd
xeɹndɹuɹnsɹop	keɹndɹʊɹnsɹob
tsiŋgɹiɹslifp	tsɪnkɹiɹslɪfp
bɹuɹmpɸuknɹɔɹp	pɹuɹnpfʊknɹɔɹb
sɔɹlnuɹgnɹoɹn	tɔɹlnuɹknɹoɹn
snestlɔɹlsuns	snestlɔɹlsʊns
ɹiɹnsɹɛsdɹæɹs	ɹiɹnsɹɛsdɹaɹs
snɛɹglæɹdɣis	snɛɹklaɹdgis
sufsninsɸup	tufsnɪnspʊb
tsuɹbsɛɹdbɹɛf	tsʊɹbsɛɹtbɹɛf
lɔɹlbɹægβup	lɔɹlpɹagbub
siɹdsnisip	tɪɹtsnisip
nopsɹulzit	nopsɹuldɪd
iɹdɸɶnoɹk	ɪɹdpanoɹk
fɹupsæsdɹuɹs	fɹʊpsastɹʊɹs
bɹɔdquɹgpɸɛp	bɹɔdkuɹgpfɛb
sɹuknuɹsgɹæɹn	sɹʊknuɹsgɹaɹn
bɹɛtdɹæpɸuɹt	pɹɛtdɹapfʊɹd
gɹoɹɱfɔbɹup	gɹoɹnfɔpɹub
sɹɔfpɸiɹssnef	sɹɔfpfɪɹssnef
ɹupzoffuɹt	ɹupdoffʊɹd
pɸoɹntsefpzis	pfoɹntsefpdɪs
eɹbseɹfbyɹt	eɹpseɹfbɪɹd
fɛxeɹdbɹuɹt	fɛkeɹdpɹuɹt
nɹæbɹɔɹbɹet	nɹabɹɔɹbɹed
siɹbfeɹfæt	siɹpfeɹfat
tsæɹdsoɹsdɹæt	tsaɹtsoɹstɹad
iɹgɸɔkfe	ɪɹgpɔkfe
dɹunsnɛɹgpɸɛp	dɹʊnsnɛɹgpfɛb
lɹiddɹɔɹldɹeɹl	lɹɪdtɹɔɹltɹeɹl
pɸiɹdβøfxek	pfiɹtbefkeg
ɹɛɹlsedsɹuns	ɹɛɹltedsɹʊns
fɹostsɹilpɸæns	fɹostsɹilpfans
tsoɹfqɔllɹɛf	tsoɹfkɔllɹɛf
ɸɔɹfɢudgɹɛs	pɔɹfgudkɹɛs
tsɔkgɹiɹddɹust	tsɔkgɹiɹtdɹʊst
gɹofplɹonnɹæns	gɹofplɹonnɹans
ɣiɹfgɹepdɹɛɹk	gɪɹfkɹepdɹɛɹg
nɹækbɹinsgɹɔɹk	nɹakpɹinskɹɔɹk
lɹitfupgɹit	lɹɪtfupgɹɪt
gɹoɹfnɹuɹbɸøfp	kɹoɹfnɹuɹppefp
ɸilbɹiɹdfɹuɹp	pilpɹɪɹdfɹʊɹp
dɹeɹbfidɹɛɹn	tɹeɹbfɪdɹɛɹn
gɹiɹgsnostnɛɹp	kɹiɹgsnostnɛɹb
dæɹdβøkfɹuɹp	daɹdbekfɹuɹb
nɛɹnlɹɛstɣiɹt	nɛɹnlɹɛstgiɹt
ofpzuɹzoɹs	ofpdʊɹtoɹs
nætfæɹdqɔɹs	natfaɹtkɔɹs
fɹɔfpzeɹbsost	fɹɔfpdeɹbtost
fɹistfæɹɣis	fɹistfaɹgɪs
dɹiɹŋqɔbβol	dɹiɹnkɔbbol
læɹlnɔɹsbɹiɹ	laɹlnɔɹsbɹɪɹ
ɸœɹdβɔfpgɹæɹl	pɛɹdbɔfpgɹaɹl
bɹoɹgsɹɛɹdgɹæst	bɹoɹgsɹɛɹdgɹast
dɹɔpɸɔklɔɹ	dɹɔpfɔklɔɹ
pɸiɹbsiɹggɹuɹf	pfiɹbtiɹkkɹʊɹf
quɹfsɔɹdpɸeɹt	kʊɹfsɔɹtpfeɹd
qoknuɹdsup	koknuɹtsʊb
bɹodɸuɹfæl	pɹodpʊɹfal
nɹɛglɛɹŋɣeɹl	nɹɛglɛɹngeɹl
bɹɛɹgnɹæbfɹot	pɹɛɹgnɹabfɹod
nɹoɹbxistbɹɔɹk	nɹoɹpkɪstpɹɔɹk
sexeɹsnɹon	tekeɹsnɹon
xiɹfsniglɹip	kɪɹfsniglɹip
bɹiɹsdɹullɹæl	bɹɪɹsdɹullɹal
ɢubnɛfdɹuɹf	gubnɛftɹʊɹf
tsoɹgfɹibbɹuns	tsoɹgfɹibbɹuns
bɹokbɹiŋgɹil	pɹokpɹingɹil
ziɹgβɔɹdβok	dɪɹkbɔɹtbog
efæɹdgɹip	efaɹdkɹib
nɹuɹlzumbɹa	nɹuɹldunpɹa
fussɛɹbgɹut	fʊstɛɹbkɹud
dɹiɹgleɹgfɹɛɹn	tɹɪɹgleɹgfɹɛɹn
gɹuɹgnæbɹu	gɹuɹgnabɹʊ
siɹfbɹuɹggɹɛp	siɹfbɹʊɹgkɹɛb
nɹensfɹiɹlpɸup	nɹensfɹɪɹlpfup
lɹæɹbɸuɹflɹæɹf	lɹaɹbpuɹflɹaɹf
quɹgpɸɔɹfgæɹk	kuɹgpfɔɹfgaɹg
ɹægɢɔɹɱfɹiɹk	ɹaggɔɹnfɹiɹg
sɛɹbdɹinstsit	sɛɹpdɹɪnstsɪd
dɹɛnsbɹɔɹbɸɔp	dɹɛnsbɹɔɹbpɔp
ɛɹgpɸɛɹdziɹp	ɛɹkpfɛɹtdiɹp
siɹbzesxek	tɪɹbdeskek
bɹuɹlzɔstsnul	bɹʊɹldɔstsnul
lænssnuɹggɹuɹs	lanssnʊɹgkɹʊɹs
bɹinsgɹeɹbɹɔɹp	pɹɪnskɹeɹpɹɔɹp
snɔɹsdɹiɹfɸul	snɔɹstɹiɹfpʊl
lɹuɹbdɹubɸɶt	lɹuɹbtɹʊbpad
gɹonssnɛspɸuns	kɹonssnɛspfʊns
dɹɔɹβøɹbsɹæt	dɹɔɹpeɹpsɹad
iɹdɸøɹsbɹok	ɪɹtpeɹspɹog
sɹiɹbβɔɹbgɹup	sɹiɹbbɔɹbgɹʊb
sneɹgnɹebfɹil	sneɹknɹebfɹɪl
nædɹifbɹul	natɹifpɹul
bɹuɹdɹiɹbfæl	bɹʊɹdɹiɹpfal
supdɹæstfɹok	supdɹastfɹok
gɹɛldɹensfeɹf	gɹɛldɹensfeɹf
bɹiɹdɸibbɹæɹk	bɹɪɹtpibbɹaɹk
βɔpɸɔŋgɹiɹn	bɔpfɔnkɹɪɹn
βøɹdnuɹsgɹæɹp	beɹtnʊɹskɹaɹp
bɹæssukxik	bɹastukkik
sɹulɸœbgɹuɹp	sɹʊlpɛbkɹʊɹb
sixɛknæk	tikɛknak
sɹoɹlɛɹlef	sɹoɹlɛɹlef
lɹɔɹgɹɔŋgɹɛp	lɹɔɹgɹɔnkɹɛb
uɹssɹɔɹbnef	ʊɹssɹɔɹpnef
zɔquptsuɹp	dɔkuptsuɹb
gɹuɹbɣɛstɣi	gɹʊɹbgɛstgɪ
ɸœgpɸiɹnsnuk	pɛgpfiɹnsnuk
ɣiftsæpzip	gɪftsapdɪb
fɹiɹlsnækdɹut	fɹɪɹlsnakdɹut
pɸiɹntæpgæɹ	pfɪɹntapgaɹ
gɹeddɹæɹdfɹuɹ	kɹeddɹaɹdfɹuɹ
bɹɛplɔɹsil	bɹɛplɔɹsil
gɹodgɹinssnɔt	kɹodgɹinssnɔt
næfsɹɛlsɹæns	nafsɹɛlsɹans
ɔɹɱfibɹek	ɔɹnfibɹek
βœɹfsɛnsɹæs	bɛɹftɛnsɹas
xefzɛlnɹiɹn	kefdɛlnɹɪɹn
gɹeɹβɔkɣiɹp	gɹeɹbɔkgɪɹp
luɹlnɹuɹgdɹuɹk	luɹlnɹʊɹkdɹʊɹg
bɹiɹŋgɹeɹdzut	pɹɪɹnkɹeɹtdud
ɸuɹfgɹɔfpnæns	pʊɹfgɹɔfpnans
zoɹɱfɹæɹszɔns	doɹnfɹaɹsdɔns
qɔɹgɣiɹlfuɹs	kɔɹggiɹlfuɹs
ɸuɹgdɹɛsfæɹf	pʊɹgtɹɛsfaɹf
tsufpzugɹul	tsʊfpdukɹul
ɣɛlnɹuszip	gɛlnɹusdib
dɹustsɹɔɹgfuɹt	tɹʊstsɹɔɹgfʊɹt
bɹofpbɹɛbdɹist	bɹofppɹɛbdɹist
sɹedɹiflɹok	sɹedɹɪflɹog
ɸuɹgdɹɔɹbbɹip	puɹktɹɔɹppɹɪb
ɸuɹlɢɔŋgɹuɹk	puɹlgɔngɹʊɹk
tsensnɹuɹbfil	tsensnɹuɹpfil
fɹɛɹfbɹɔfgɹup	fɹɛɹfpɹɔfgɹub
neɹgɣenssuɹl	neɹkgenstʊɹl
pɸiɹggɹuɹfik	pfɪɹkgɹʊɹfik
snuɹbnæbbɹe	snʊɹpnabbɹe
sɛxɛɹbgɹuɹt	tɛkɛɹpgɹʊɹt
dɹɛssuɹbɸop	dɹɛstʊɹbpop
ɹoɹlfiɱfek	ɹoɹlfinfeg
gɹunsbɹɛtɢup	kɹunspɹɛtgʊb
noɹbɹæmpɸeɹn	noɹpɹanpfeɹn
liɹbbɹuɹfpɸip	lɪɹbpɹuɹfpfib
uknɹeɹbnɹit	ʊknɹeɹpnɹid
dɹɛfpsɹæfɣiɹp	tɹɛfpsɹafgɪɹb
xistlusdɹɔɹn	kɪstlʊstɹɔɹn
ɢɔbɢuptsit	gɔbgʊptsɪd
ɸɔnsbɹigdɹut	pɔnspɹigtɹʊd
nisbyplɹiɹp	nisbɪplɹiɹp
lɹɔtlɹɔɹdsniɹl	lɹɔtlɹɔɹtsnɪɹl
luszuɹsɣiɹs	lʊsdʊɹsgiɹs
dæɹspɸæɹmɸøɹn	daɹspfaɹnpeɹn
ɹuɹnsoɹdgɹæt	ɹuɹnsoɹdgɹat
gɹɔtsɹuɹgtsɔt	gɹɔtsɹuɹktsɔd
dɹuɹfzeɹgɹens	dɹuɹfdeɹkɹens
βoɹbbɹoɹbdɹɛp	boɹpbɹoɹpdɹɛb
soɹŋquɹdnɹuk	soɹnkʊɹtnɹʊk
βɔnstsustsnɛɹs	bɔnstsustsnɛɹs
ɸuɹsnɹiɹllɹæɹt	pʊɹsnɹɪɹllɹaɹd
tsiɹgquɹnɹeɹf	tsɪɹgkuɹnɹeɹf
lunsβɔgsok	lʊnsbɔgtok
byblufnist	bɪblʊfnɪst
bɹɔstfofbɹeɹp	pɹɔstfofpɹeɹp
ɣiɹstsuɹlnɹæs	giɹstsʊɹlnɹas
lɹinstsɔɹβis	lɹɪnstsɔɹpis
nedbɹoɹdsnoɹn	nedpɹoɹdsnoɹn
bɹɛɹdlɛɹbnuk	pɹɛɹtlɛɹpnʊg
pɸeɹbqɔpbɹil	pfeɹpkɔpbɹɪl
pɸiɹbneɹdnɹif	pfɪɹpneɹtnɹif
tsedɹistnɹuɹl	tsedɹistnɹʊɹl
ɸœɹdlɹozuɹ	pɛɹdlɹoduɹ
sɹiɹbfeɹdnɹiɹt	sɹɪɹpfeɹdnɹɪɹd
nistβøxeɹ	nistbekeɹ
bɹoɹgfɹæɹbdɹuɹp	bɹoɹgfɹaɹpdɹuɹb
qunefsiɹt	kunefsɪɹt
ɣeɹggɹæɹflɹof	geɹkkɹaɹflɹof
seɹfsesgɹɔɹk	seɹfseskɹɔɹg
snɔɹlpɸotɢust	snɔɹlpfotgust
gɹifppɸeɹbsniɹt	gɹɪfppfeɹbsniɹt
ɹistbɹɔsbɹip	ɹistpɹɔsbɹɪp
ziɹbbɹɔstbɹuns	diɹbbɹɔstpɹʊns
βɶɹgɢunssɛɹp	baɹggunstɛɹb
fostlæɹgtæɹs	fostlaɹktaɹs
ɹuɹnsnoggɹoɹn	ɹuɹnsnogkɹoɹn
dɹupbyɹgnɹoɹk	dɹupbɪɹgnɹoɹg
bɹiɱfɹumbɹiɹt	bɹinfɹʊnbɹiɹt
dɹɛddɹæstbɹoɹl	tɹɛdtɹastbɹoɹl
ɹeffɹætdɹif	ɹeffɹattɹif
βœɱfɹiɹbgɹiɹ	bɛnfɹɪɹbgɹɪɹ
ustxɛgsip	ʊstkɛgsip
nɹukɸiɹgfɹul	nɹukpiɹkfɹul
bɹɛsɹɔɹfsɹin	bɹɛsɹɔɹfsɹin
ɹɛnstsopɸɛɹp	ɹɛnstsopfɛɹp
suɹbsoɹdfɛl	tʊɹbtoɹdfɛl
lɹɛbzubgɹik	lɹɛbdʊbkɹig
lɹɔɹgβuɹdnɔp	lɹɔɹkbʊɹdnɔp
sobsigɣiɹn	tobtɪggiɹn
tsɛɹdzoɹbɸɔl	tsɛɹtdoɹbpɔl
dɹɔɢofpdɹufp	tɹɔgofptɹufp
snɛɹbzuɹgfɹuɹk	snɛɹbdʊɹkfɹuɹg
iɹnnɹɛɹggɹip	ɪɹnnɹɛɹgkɹɪp
sɹostsnɔɹbgɹens	sɹostsnɔɹpkɹens
βœtbɹuɹnseɹl	bɛtbɹuɹnseɹl
siɹbzekbɹɛp	tiɹbdekbɹɛb
fɹæɹfɹutsnuns	fɹaɹfɹutsnʊns
sæɹgzuknɹif	saɹgduknɹɪf
tsutdætɸɶs	tsutdatpas
liptsuɹgzoɹl	liptsuɹkdoɹl
dɹunnɹudnef	dɹunnɹudnef
ɢubɢobgɹuk	gubgobgɹug
tsɛɹlbɹeɹsɸufp	tsɛɹlpɹeɹspʊfp
zusdɹɛpɸit	dʊstɹɛpfid
gɹigfɛβuf	gɹigfɛbʊf
qoknɔɹnlɹæk	koknɔɹnlɹag
ɹustɸɶksuɹ	ɹʊstpaksuɹ
zidgɹiflof	didkɹɪflof
gɹeŋgædgɹɛst	kɹengadgɹɛst
gætnɔdgɹɛk	gatnɔdgɹɛg
qoɹbsɹuɹdxiɹt	koɹpsɹuɹtkɪɹt
nɔɹdpɸɔbgɹuɹ	nɔɹdpfɔbkɹʊɹ
fɹostsɔpɸɹit	fɹostsɔpfɹid
gɹokdɹuɹmbɹel	kɹoktɹuɹnbɹel
gæglefplif	gaglefplɪf
pɸɛlβɔɹbbɹuɹt	pfɛlbɔɹppɹuɹt
fɹukdɹopsɹɔs	fɹukdɹopsɹɔs
gɹebsnulnɹiɹn	kɹebsnʊlnɹɪɹn
fɹiklutβuɹk	fɹɪklʊtbuɹk
gɹuɹmpɸefpβufp	kɹʊɹnpfefpbʊfp
bɹɔsullɹos	bɹɔtullɹos
dɹoɹfɹopβɔɹs	dɹoɹfɹopbɔɹs
gɹæfpdɹiɹfɣɛk	gɹafpdɹiɹfgɛg
fɹɛɹgɹɛstβut	fɹɛɹkɹɛstbʊt
xipsilsɔl	kɪptilsɔl
iɹbgɹubyɹ	ɪɹbgɹʊbɪɹ
nɔɹstsoɹlgɹoɹn	nɔɹstsoɹlgɹoɹn
gɹiɹgpɸoɹsɹuf	gɹiɹkpfoɹsɹʊf
zɔɹsfɹɛɹbgɹuɹn	dɔɹsfɹɛɹbkɹuɹn
xifkæquɹk	kɪfkakʊɹk
liɹsβuknɹiɹn	lɪɹsbuknɹiɹn
nɹɔpdɹelfɹuɹs	nɹɔptɹelfɹuɹs
sɹɔɹsfulsost	sɹɔɹsfʊlsost
fusfinstsiɹp	fʊsfɪnstsɪɹb
sifβɶɹnnɛk	tɪfbaɹnnɛk
nɛɹgtsɔɹbtsuf	nɛɹgtsɔɹbtsuf
fiɹgbɹuɹgɹuf	fɪɹkbɹʊɹkɹuf
dɹunsnɹuftsus	tɹʊnsnɹʊftsus
tsufpgɹiɹnsoɹs	tsʊfpkɹɪɹnsoɹs
zifpbɹusbɹæɹt	dɪfppɹʊsbɹaɹt
nɹustæɹdnɹɔɹp	nɹʊstaɹdnɹɔɹp
dɹofpsɹiɹbdɹet	dɹofpsɹɪɹbtɹed
nobɸuɹdɸuɹp	nobpʊɹtpʊɹp
dɹebsobgɹeɹf	tɹebtobkɹeɹf
nɔfpnɹoɹun	nɔfpnɹoɹun
ɹubnɹoɹbnɹuɹp	ɹʊbnɹoɹbnɹuɹp
nɹostfɹestxeɹp	nɹostfɹestkeɹp
gɹɛɹbgɹæknest	gɹɛɹbgɹaknest
ɸøɹgnɹiɹdɹuɹl	peɹgnɹiɹtɹʊɹl
nɹoɹbbɹelfæp	nɹoɹbpɹelfap
fɹiɹgæɹdnɹɛst	fɹɪɹkaɹtnɹɛst
fɹɔɹmɸonsbɹon	fɹɔɹnponspɹon
bɹɛɹɢobpɸiɹf	bɹɛɹkobpfɪɹf
feɹfɔplɹust	feɹfɔplɹust
xidnoɹbqɔɹ	kɪdnoɹbkɔɹ